,id,release_date,movie,production_budget,domestic_gross,worldwide_gross,international_gross,genre_ids
0,1,"Dec 18, 2009",Avatar,425,760,2776,2016,"[action, adventure, fantasy, sci-fi]"
1,2,"May 20, 2011",Pirates of the Caribbean: On Stranger Tides,410,241,1045,804,"[adventure, action, fantasy]"
2,4,"May 1, 2015",Avengers: Age of Ultron,330,459,1403,944,"[action, adventure, sci-fi]"
3,7,"Apr 27, 2018",Avengers: Infinity War,300,678,2048,1370,"[adventure, action, fantasy]"
8,11,"Jul 20, 2012",The Dark Knight Rises,275,448,1084,636,"[action, crime, drama, thriller]"
9,12,"May 25, 2018",Solo: A Star Wars Story,275,213,393,180,"[action, adventure, sci-fi]"
10,13,"Jul 2, 2013",The Lone Ranger,275,89,260,171,"[action, adventure, western]"
11,14,"Mar 9, 2012",John Carter,275,73,282,209,"[action, adventure, sci-fi]"
12,15,"Nov 24, 2010",Tangled,260,200,586,386,"[animation, family]"
13,17,"May 6, 2016",Captain America: Civil War,250,408,1140,732,"[adventure, action, sci-fi]"
14,18,"Mar 25, 2016",Batman v Superman: Dawn of Justice,250,330,867,537,"[action, adventure, fantasy]"
15,19,"Dec 14, 2012",The Hobbit: An Unexpected Journey,250,303,1017,714,"[adventure, fantasy, action]"
16,21,"Dec 13, 2013",The Hobbit: The Desolation of Smaug,250,258,960,702,"[adventure, fantasy, action]"
17,22,"Dec 17, 2014",The Hobbit: The Battle of the Five Armies,250,255,945,690,"[action, adventure, fantasy]"
18,23,"Apr 14, 2017",The Fate of the Furious,250,225,1234,1009,"[action, crime, thriller]"
19,25,"May 26, 2017",Pirates of the Caribbean: Dead Men Tell No Tales,230,172,788,616,"[adventure, action, fantasy, comedy]"
22,29,"Jun 14, 2013",Man of Steel,225,291,667,376,"[action, adventure, fantasy, sci-fi]"
23,31,"Jul 3, 2012",The Amazing Spider-Man,220,262,757,495,"[action, adventure, fantasy]"
24,32,"May 18, 2012",Battleship,220,65,313,248,"[thriller, action, adventure, sci-fi]"
25,33,"Jun 21, 2017",Transformers: The Last Knight,217,130,602,472,"[action, sci-fi, thriller, adventure]"
26,34,"Jun 12, 2015",Jurassic World,215,652,1648,996,"[action, adventure, sci-fi, thriller]"
27,35,"May 25, 2012",Men in Black 3,215,179,654,475,"[action, comedy, sci-fi]"
28,37,"Jun 27, 2014",Transformers: Age of Extinction,210,245,1104,859,"[sci-fi, action, adventure]"
37,44,"Jun 15, 2018",Incredibles 2,200,608,1242,634,"[action, adventure, animation, family]"
40,46,"Jun 17, 2016",Finding Dory,200,486,1021,535,"[adventure, animation, comedy, family]"
41,47,"Jun 18, 2010",Toy Story 3,200,415,1068,653,"[animation, family, comedy]"
42,48,"May 3, 2013",Iron Man 3,200,408,1215,807,"[action, adventure, sci-fi]"
45,52,"Nov 8, 2012",Skyfall,200,304,1110,806,"[action, adventure, thriller]"
46,53,"Jun 21, 2013",Monsters University,200,268,743,475,"[animation, family]"
47,54,"Mar 8, 2013",Oz the Great and Powerful,200,234,490,256,"[fantasy, adventure, family]"
48,55,"May 23, 2014",X-Men: Days of Future Past,200,233,747,514,"[action, adventure, fantasy, sci-fi]"
49,56,"May 2, 2014",The Amazing Spider-Man 2,200,202,708,506,"[action, adventure, fantasy]"
50,57,"Jun 24, 2011",Cars 2,200,191,560,369,"[animation, family, adventure, comedy]"
51,59,"Nov 13, 2009",2012,200,166,757,591,[documentary]
52,60,"Nov 16, 2018",Fantastic Beasts: The Crimes of Grindelwald,200,159,652,493,[adventure]
53,62,"Jun 17, 2011",Green Lantern,200,116,219,103,"[adventure, action, thriller, sci-fi]"
54,64,"Jun 29, 2011",Transformers: Dark of the Moon,195,352,1123,771,"[action, sci-fi, adventure]"
57,66,"Mar 1, 2013",Jack the Giant Slayer,195,65,197,132,"[action, adventure, family, fantasy]"
58,67,"Apr 3, 2015",Furious 7,190,353,1518,1165,"[action, crime, thriller]"
59,68,"May 16, 2013",Star Trek Into Darkness,190,228,467,239,"[action, adventure, sci-fi]"
60,69,"Jun 21, 2013",World War Z,190,202,531,329,"[action, drama, horror, sci-fi, thriller]"
61,70,"May 10, 2013",The Great Gatsby,190,144,351,207,"[drama, romance]"
62,72,"Jul 12, 2013",Pacific Rim,190,101,411,310,"[action, sci-fi, adventure]"
65,75,"Jul 18, 2008",The Dark Knight,185,533,1001,468,"[action, crime, drama, thriller]"
68,78,"Mar 10, 2017",Kong: Skull Island,185,168,561,393,"[action, adventure, fantasy]"
69,79,"Jul 22, 2016",Star Trek Beyond,185,158,335,177,"[action, adventure, sci-fi]"
74,84,"May 30, 2014",Maleficent,180,241,758,517,"[fantasy, adventure, action, family, romance]"
77,88,"Jul 1, 2016",The Legend of Tarzan,180,126,348,222,"[action, adventure]"
78,89,"Nov 23, 2011",Hugo,180,73,180,107,"[adventure, drama, family]"
79,90,"Jul 21, 2017",Valerian and the City of a Thousand Planets,180,40,215,175,"[adventure, sci-fi, action]"
80,91,"Feb 6, 2015",Jupiter Ascending,179,47,181,134,"[sci-fi, fantasy, action, adventure]"
81,93,"May 27, 2016",X-Men: Apocalypse,178,155,542,387,"[action, adventure, sci-fi, fantasy]"
82,94,"Aug 10, 2018",The Meg,178,145,529,384,"[action, sci-fi, thriller, horror]"
83,95,"Jun 6, 2014",Edge of Tomorrow,178,100,370,270,"[action, sci-fi]"
84,97,"Apr 15, 2016",The Jungle Book,175,364,962,598,"[adventure, drama, family, fantasy]"
87,99,"Jul 7, 2017",Spider-Man: Homecoming,175,334,880,546,"[action, adventure, sci-fi, drama]"
88,100,"Aug 5, 2016",Suicide Squad,175,325,746,421,"[action, adventure, crime, fantasy, sci-fi]"
91,5,"Jun 16, 2017",Cars 3,175,152,383,231,"[adventure, animation, comedy, family]"
92,11,"May 12, 2017",King Arthur: Legend of the Sword,175,39,139,100,"[action, drama, fantasy]"
93,12,"Dec 25, 2013",47 Ronin,175,38,151,113,"[drama, action, adventure, fantasy]"
94,13,"Jun 22, 2018",Jurassic World: Fallen Kingdom,170,417,1305,888,"[action, adventure, sci-fi]"
95,14,"Aug 1, 2014",Guardians of the Galaxy,170,333,770,437,"[action, sci-fi, adventure]"
96,15,"May 7, 2010",Iron Man 2,170,312,621,309,"[adventure, action, sci-fi]"
97,16,"Apr 4, 2014",Captain America: The Winter Soldier,170,259,714,455,"[action, adventure, sci-fi]"
98,17,"Jul 11, 2014",Dawn of the Planet of the Apes,170,208,710,502,"[sci-fi, action, drama, thriller]"
99,19,"Jun 1, 2012",Snow White and the Huntsman,170,155,401,246,"[adventure, fantasy, drama]"
100,21,"May 7, 2004",Van Helsing,170,120,300,180,"[horror, adventure, action]"
101,23,"May 22, 2015",Tomorrowland,170,93,206,113,"[adventure, family, mystery, sci-fi]"
102,26,"May 27, 2016",Alice Through the Looking Glass,170,77,276,199,"[adventure, family, fantasy]"
103,27,"May 21, 2010",Shrek Forever After,165,238,756,518,"[comedy, adventure, fantasy, animation, family]"
108,30,"Mar 26, 2010",How to Train Your Dragon,165,217,494,277,"[fantasy, adventure, animation, family]"
109,31,"Nov 2, 2012",Wreck-It Ralph,165,189,496,307,"[family, animation, comedy, adventure]"
110,32,"Nov 5, 2014",Interstellar,165,188,666,478,"[adventure, drama, sci-fi]"
111,33,"Jun 24, 2016",Independence Day: Resurgence,165,103,384,281,"[action, adventure, sci-fi]"
118,36,"Dec 21, 2018",Aquaman,160,335,1146,811,"[action, adventure, fantasy]"
119,38,"Jul 16, 2010",Inception,160,292,835,543,"[action, sci-fi, adventure]"
124,42,"Jun 3, 2011",X-Men: First Class,160,146,355,209,"[action, sci-fi, adventure]"
125,44,"Jul 14, 2010",The Sorcerer's Apprentice,160,63,217,154,"[fantasy, adventure, action, comedy, drama]"
126,46,"Jun 10, 2016",Warcraft,160,47,425,378,"[action, adventure, fantasy]"
129,48,"Dec 10, 2010",The Chronicles of Narnia: The Voyage of the Dawn Treader,155,104,418,314,"[adventure, family, fantasy]"
130,50,"Mar 23, 2018",Pacific Rim: Uprising,155,59,290,231,"[action, fantasy, sci-fi, adventure]"
131,52,"Jul 14, 2017",War for the Planet of the Apes,152,146,489,343,"[drama, sci-fi, war]"
136,57,"Mar 4, 2016",Zootopia,150,341,1019,678,"[animation, adventure, family, comedy]"
140,66,"Nov 8, 2013",Thor: The Dark World,150,206,644,438,"[action, adventure, fantasy]"
141,69,"Jul 21, 2017",Dunkirk,150,190,499,309,"[war, action, drama]"
142,70,"May 6, 2011",Thor,150,181,449,268,"[adventure, fantasy, action]"
143,74,"May 26, 2011",Kung Fu Panda 2,150,165,664,499,"[animation, family]"
144,75,"May 15, 2015",Mad Max: Fury Road,150,153,370,217,"[action, adventure, sci-fi]"
145,78,"Mar 29, 2018",Ready Player One,150,137,579,442,"[adventure, sci-fi]"
146,83,"Jul 1, 2010",The Last Airbender,150,131,319,188,"[action, adventure, family, fantasy]"
147,87,"Mar 30, 2012",Wrath of the Titans,150,83,305,222,"[fantasy, adventure, action]"
148,89,"May 11, 2012",Dark Shadows,150,79,238,159,"[comedy, fantasy]"
149,90,"Jun 28, 2013",White House Down,150,73,205,132,"[action, drama, thriller]"
150,91,"Feb 12, 2010",The Wolfman,150,62,142,80,[horror]
151,92,"Feb 17, 2017",The Great Wall,150,45,334,289,"[action, adventure, fantasy]"
152,93,"Oct 9, 2015",Pan,150,35,151,116,"[adventure, family, fantasy]"
153,94,"Mar 11, 2011",Mars Needs Moms,150,21,39,18,"[adventure, animation, family]"
154,97,"Jun 8, 2012",Madagascar 3: Europe's Most Wanted,145,216,746,530,"[animation, family, comedy]"
155,99,"Jun 13, 2014",How to Train Your Dragon 2,145,177,614,437,"[fantasy, action, adventure, animation, comedy, family]"
156,100,"Jun 16, 1999",Tarzan,145,171,448,277,"[animation, action, adventure, family]"
157,1,"Mar 7, 2014",Mr. Peabody & Sherman,145,111,269,158,"[animation, adventure, family]"
158,2,"Nov 21, 2012",Rise of the Guardians,145,103,306,203,"[animation, family, fantasy]"
161,8,"Jul 1, 1998",Armageddon,140,201,554,353,"[action, thriller, sci-fi, adventure]"
162,10,"Jul 22, 2011",Captain America: The First Avenger,140,176,370,194,"[action, adventure, sci-fi]"
163,11,"Jan 29, 2016",Kung Fu Panda 3,140,143,517,374,"[action, adventure, animation, comedy, family]"
164,13,"Mar 27, 2013",G.I. Joe: Retaliation,140,122,375,253,"[adventure, action, sci-fi, thriller]"
165,16,"Dec 12, 2014",Exodus: Gods and Kings,140,65,268,203,"[adventure, drama, action]"
166,17,"Jul 1, 2016",The BFG,140,55,199,144,"[adventure, family, fantasy]"
167,18,"Feb 26, 2016",Gods of Egypt,140,31,138,107,"[action, adventure, fantasy, sci-fi]"
168,26,"Mar 22, 2013",The Croods,135,187,573,386,"[action, adventure, animation, comedy, family, fantasy]"
171,29,"Mar 4, 2011",Rango,135,123,245,122,"[animation, comedy, family, western, adventure]"
172,31,"Jul 17, 2013",Turbo,135,83,286,203,"[animation, family]"
173,32,"Jun 3, 2016",Teenage Mutant Ninja Turtles: Out of the Shadows,135,82,245,163,"[action, adventure, comedy, family, sci-fi]"
174,33,"Nov 18, 2011",Happy Feet Two,135,64,157,93,"[animation, comedy, family]"
175,35,"Nov 2, 2018",The Nutcracker and the Four Realms,132,54,170,116,"[fantasy, adventure, family]"
176,36,"Jun 29, 2005",War of the Worlds,132,234,606,372,[documentary]
177,37,"Nov 26, 2014",Penguins of Madagascar,132,83,366,283,"[family, animation, adventure, comedy]"
178,38,"Nov 22, 2013",The Hunger Games: Catching Fire,130,424,864,440,"[adventure, action, sci-fi]"
179,40,"Aug 3, 2007",The Bourne Ultimatum,130,227,444,217,"[action, drama, mystery, thriller]"
180,41,"Jul 6, 2018",Ant-Man and the Wasp,130,216,623,407,"[action, adventure, sci-fi, comedy]"
181,43,"Jul 17, 2015",Ant-Man,130,180,518,338,"[sci-fi, action, adventure]"
189,45,"Dec 19, 2018",Mary Poppins Returns,130,171,341,170,"[fantasy, family, comedy]"
190,46,"Oct 28, 2011",Puss in Boots,130,149,554,405,"[action, adventure, animation, family, fantasy, comedy]"
191,47,"Nov 5, 2010",Megamind,130,148,321,173,"[animation, action, comedy, family, sci-fi]"
192,49,"Apr 11, 2014",Rio 2,130,131,492,361,"[adventure, comedy, family, animation]"
198,52,"Dec 21, 2011",The Adventures of Tintin,130,77,373,296,"[adventure, animation, mystery]"
199,53,"May 31, 2013",After Earth,130,60,251,191,"[sci-fi, action, adventure]"
200,55,"Jul 19, 2013",R.I.P.D.,130,33,79,46,"[fantasy, action, comedy, crime]"
203,60,"Dec 19, 2014",Night at the Museum: Secret of the Tomb,127,113,353,240,"[adventure, comedy, fantasy, family]"
204,62,"Nov 21, 2014",The Hunger Games: Mockingjay - Part 1,125,337,766,429,"[sci-fi, adventure, thriller]"
205,67,"Apr 29, 2011",Fast Five,125,210,630,420,"[action, thriller, crime]"
208,69,"Dec 16, 2011",Sherlock Holmes: A Game of Shadows,125,186,535,349,"[adventure, action, crime, mystery]"
209,71,"Mar 31, 2017",The Boss Baby,125,175,510,335,"[animation, comedy, family]"
214,75,"Jun 8, 2012",Prometheus,125,126,402,276,"[sci-fi, adventure, mystery]"
215,76,"Aug 10, 2012",The Bourne Legacy,125,113,280,167,"[action, thriller]"
216,78,"Jul 13, 2018",Skyscraper,125,68,304,236,[action]
219,81,"Jan 13, 2017",Monster Trucks,125,33,61,28,"[action, comedy, sci-fi]"
220,86,"Jul 29, 2016",Jason Bourne,120,162,416,254,"[action, thriller]"
221,88,"Nov 21, 2012",Life of Pi,120,124,620,496,"[adventure, drama, action]"
222,90,"Apr 13, 2018",Rampage,120,101,428,327,"[action, adventure, sci-fi, fantasy]"
223,92,"Aug 9, 2013",Elysium,120,93,286,193,"[sci-fi, action, drama, thriller]"
224,93,"Apr 19, 2013",Oblivion,120,89,287,198,"[action, sci-fi, adventure, mystery]"
225,94,"Mar 24, 2017",Power Rangers,120,85,142,57,"[action, adventure, sci-fi]"
226,96,"Feb 12, 2014",RoboCop,120,58,242,184,"[action, sci-fi]"
229,2,"Jun 23, 2010",Knight and Day,117,76,258,182,"[action, comedy]"
232,8,"Jul 26, 2013",The Wolverine,115,132,416,284,"[action, sci-fi, adventure, fantasy]"
233,9,"Feb 7, 1997",Dante's Peak,115,67,178,111,"[action, adventure, thriller, drama]"
234,13,"Dec 25, 2010",Gulliver's Travels,112,42,232,190,"[comedy, adventure, family, fantasy]"
237,15,"May 18, 2018",Deadpool 2,110,324,786,462,"[action, comedy, adventure]"
238,16,"Oct 4, 2013",Gravity,110,274,693,419,"[sci-fi, thriller, drama]"
239,19,"May 29, 2015",San Andreas,110,155,456,301,"[action, drama, thriller]"
240,20,"Jul 29, 2011",The Smurfs,110,142,563,421,"[animation, family, adventure, comedy, fantasy]"
241,26,"Mar 7, 2014",300: Rise of an Empire,110,106,330,224,"[action, war, fantasy]"
244,29,"Jan 14, 2011",The Green Hornet,110,98,229,131,"[action, crime, comedy]"
245,31,"Oct 7, 2011",Real Steel,110,85,263,178,"[action, sci-fi, drama]"
246,32,"Jun 11, 2010",The A-Team,110,77,177,100,"[thriller, action, adventure, comedy, crime]"
247,33,"Jul 31, 2013",The Smurfs 2,110,71,348,277,"[fantasy, family, comedy, animation]"
248,36,"Nov 1, 2013",Ender's Game,110,61,127,66,"[sci-fi, action, adventure]"
249,40,"Mar 31, 2017",Ghost in the Shell,110,40,167,127,"[action, sci-fi, thriller, drama]"
254,52,"Jul 22, 2016",Ice Age: Collision Course,105,64,402,338,"[adventure, animation, family, comedy]"
255,54,"Sep 22, 2017",Kingsman: The Golden Circle,104,100,408,308,"[action, adventure, comedy]"
256,58,"Mar 9, 2018",A Wrinkle in Time,103,100,133,33,"[adventure, sci-fi, family, fantasy]"
257,62,"Dec 21, 2018",Bumblebee,102,127,465,338,"[action, adventure, sci-fi]"
258,63,"Oct 26, 2012",Cloud Atlas,102,27,130,103,"[drama, sci-fi]"
261,69,"Dec 25, 2012",Django Unchained,100,162,449,287,"[drama, western]"
262,70,"Dec 22, 2010",Little Fockers,100,148,310,162,"[comedy, romance]"
263,74,"Aug 6, 2010",The Other Guys,100,119,170,51,"[action, comedy, crime]"
264,75,"Dec 17, 2004",Lemony Snicket's A Series of Unfortunate Events,100,118,212,94,"[adventure, comedy, family]"
265,76,"Dec 25, 2013",The Wolf of Wall Street,100,116,389,273,"[crime, drama, comedy]"
266,77,"May 24, 2013",Epic,100,107,262,155,"[animation, adventure, family, fantasy]"
267,81,"Aug 17, 2012",The Expendables 2,100,85,311,226,"[action, adventure, thriller]"
270,85,"Dec 10, 2010",The Tourist,100,67,278,211,"[action, thriller, romance]"
271,90,"Sep 24, 2010",Legend of the Guardians: The Owls of Ga'Hoole,100,55,139,84,"[animation, adventure, family, fantasy]"
272,96,"Aug 15, 2014",The Expendables 3,100,39,209,170,"[action, adventure, thriller]"
273,98,"Mar 12, 2010",Green Zone,100,35,97,62,"[war, action, adventure, drama, thriller]"
282,4,"Dec 14, 2018",Mortal Engines,100,15,85,70,"[adventure, fantasy]"
285,12,"May 19, 2017",Alien: Covenant,97,74,238,164,"[horror, sci-fi, thriller]"
290,14,"Jul 13, 2012",Ice Age: Continental Drift,95,161,879,718,"[animation, comedy, adventure, family]"
291,16,"May 27, 2010",Sex and the City 2,95,95,294,199,"[comedy, drama, romance]"
292,17,"Feb 12, 2010",Percy Jackson & the Olympians: The Lightning Thief,95,88,223,135,"[adventure, fantasy, family]"
293,18,"Aug 10, 2012",The Campaign,95,86,104,18,[comedy]
296,22,"Dec 11, 2009",The Lovely Bones,95,44,94,50,"[fantasy, drama]"
297,23,"Aug 19, 2016",Ben-Hur,95,26,91,65,"[action, adventure, drama]"
298,24,"Feb 6, 2015",Seventh Son,95,17,108,91,"[adventure, fantasy]"
301,31,"Aug 5, 2011",Rise of the Planet of the Apes,93,176,470,294,"[thriller, action, drama, sci-fi]"
302,34,"Feb 14, 2013",A Good Day to Die Hard,92,67,304,237,"[action, thriller]"
303,37,"Dec 25, 2013",The Secret Life of Walter Mitty,91,58,187,129,"[adventure, comedy, drama, fantasy]"
308,42,"Dec 25, 2009",Sherlock Holmes,90,209,498,289,"[fantasy, drama, horror, action, thriller, mystery]"
309,46,"Apr 15, 2011",Rio,90,143,487,344,"[animation, adventure, comedy, family]"
310,51,"Dec 20, 2011",The Girl with the Dragon Tattoo,90,102,239,137,"[thriller, crime, mystery, drama]"
311,55,"Sep 23, 2016",The Magnificent Seven,90,93,162,69,"[adventure, action, western]"
312,56,"Dec 18, 2015",Alvin and the Chipmunks: The Road Chip,90,85,249,164,"[adventure, animation, comedy, family]"
315,64,"Aug 7, 2013",Percy Jackson: Sea of Monsters,90,68,200,132,"[adventure, family, fantasy]"
316,66,"Jun 10, 2016",Now You See Me 2,90,65,328,263,"[action, comedy, thriller]"
317,68,"Apr 4, 1997",The Saint,90,61,169,108,"[action, adventure, crime]"
318,70,"Mar 16, 2018",Tomb Raider,90,58,273,215,"[action, adventure, fantasy]"
321,77,"Oct 21, 2011",The Three Musketeers,90,20,139,119,"[adventure, action, thriller]"
325,84,"Sep 14, 2018",The Predator,88,51,159,108,"[sci-fi, action, thriller, adventure, horror]"
326,91,"Jul 23, 2004",The Bourne Supremacy,85,176,311,135,"[action, drama, thriller]"
327,95,"Mar 21, 2014",Divergent,85,150,276,126,"[action, adventure, sci-fi]"
328,96,"Sep 28, 2012",Hotel Transylvania,85,148,378,230,"[animation, comedy, family, fantasy]"
329,99,"Feb 10, 2012",Safe House,85,126,208,82,"[action, thriller]"
330,5,"Nov 4, 2011",Tower Heist,85,78,150,72,"[action, comedy]"
331,7,"Mar 30, 2012",Mirror Mirror,85,64,173,109,"[adventure, comedy, drama, family, fantasy]"
332,14,"Nov 23, 2011",Arthur Christmas,85,46,149,103,"[drama, animation, family, comedy]"
333,15,"Jan 20, 2017",xXx: Return of Xander Cage,85,44,345,301,"[action, adventure, crime]"
334,17,"Jul 30, 2010",Cats & Dogs: The Revenge of Kitty Galore,85,43,113,70,"[comedy, family, action, fantasy]"
335,21,"Mar 2, 2007",Zodiac,85,33,83,50,"[sci-fi, tv movie]"
336,24,"May 9, 1997",Father's Day,85,28,35,7,"[action, comedy, horror]"
339,28,"Jul 19, 2013",RED 2,84,53,141,88,"[action, comedy, crime, thriller]"
340,32,"Jul 11, 2008",Hellboy II: The Golden Army,82,75,160,85,"[adventure, fantasy]"
341,34,"Aug 13, 2010",The Expendables,82,103,268,165,"[thriller, adventure, action]"
342,38,"Mar 23, 2012",The Hunger Games,80,408,677,269,"[sci-fi, adventure, fantasy]"
343,39,"May 26, 2011",The Hangover Part II,80,254,586,332,[comedy]
344,41,"Feb 10, 2017",The Lego Batman Movie,80,175,310,135,"[action, animation, comedy, family, fantasy]"
345,42,"Sep 25, 2015",Hotel Transylvania 2,80,169,469,300,"[animation, comedy, family, fantasy]"
346,48,"Jul 12, 2013",Grown Ups 2,80,133,247,114,[comedy]
347,49,"Dec 16, 2011",Alvin and the Chipmunks: Chipwrecked,80,133,349,216,"[comedy, fantasy, family, music, animation]"
348,52,"Feb 19, 2010",Shutter Island,80,128,299,171,"[drama, thriller, mystery]"
349,62,"Dec 17, 2010",Yogi Bear,80,100,204,104,"[comedy, family, animation, adventure]"
350,64,"Jan 15, 2010",The Book of Eli,80,94,158,64,"[action, thriller, sci-fi]"
351,68,"Oct 17, 2014",Fury,80,85,210,125,"[war, drama, action]"
352,69,"Sep 28, 2018",Smallfoot,80,83,213,130,"[animation, family, adventure, fantasy]"
353,71,"Jul 8, 2011",Zookeeper,80,80,170,90,"[comedy, romance, family]"
358,93,"Dec 20, 2013",Walking with Dinosaurs,80,36,123,87,"[animation, family, adventure]"
359,95,"Dec 6, 1996",Daylight,80,32,158,126,"[thriller, horror]"
362,97,"Feb 21, 2014",Pompeii,80,23,108,85,"[action, adventure, history, romance, drama]"
363,100,"Dec 18, 2009",Nine,80,19,53,34,"[animation, adventure]"
364,2,"Apr 22, 2010",Oceans,80,19,86,67,"[documentary, family]"
365,9,"Jun 15, 1994",The Lion King,79,421,986,565,"[family, animation, drama]"
366,10,"Feb 10, 2012",Journey 2: The Mysterious Island,79,103,318,215,"[adventure, action, sci-fi]"
367,11,"Nov 11, 2011",Jack and Jill,79,74,150,76,[comedy]
368,13,"Sep 27, 2013",Cloudy with a Chance of Meatballs 2,78,119,274,155,"[animation, family, comedy]"
369,19,"Feb 12, 2016",The Little Prince,77,1,102,101,"[adventure, animation, fantasy, family]"
370,21,"Jul 20, 2018",The Equalizer 2,77,102,190,88,"[thriller, action, crime]"
371,22,"Jul 3, 2013",Despicable Me 2,76,368,975,607,"[animation, comedy, family]"
372,26,"Jul 8, 2016",The Secret Life of Pets,75,368,886,518,"[adventure, comedy, animation, family]"
375,30,"Jun 30, 2017",Despicable Me 3,75,264,1034,770,"[action, animation, comedy, family, adventure]"
376,34,"Jun 25, 2010",Grown Ups,75,162,272,110,[comedy]
377,41,"May 31, 2013",Now You See Me,75,117,342,225,"[thriller, crime]"
378,43,"Aug 3, 2018",Christopher Robin,75,99,197,98,"[adventure, comedy, family, fantasy]"
379,45,"Nov 11, 2011",Immortals,75,83,211,128,"[fantasy, action, drama]"
384,54,"Jun 4, 2010",Killers,75,47,95,48,"[action, comedy, thriller, romance]"
385,62,"Mar 25, 2011",Sucker Punch,75,36,89,53,"[action, fantasy, thriller]"
386,63,"Mar 11, 2005",Hostage,75,34,77,43,"[drama, horror]"
389,73,"Jul 10, 2015",Minions,74,336,1160,824,"[family, animation, adventure, comedy]"
390,74,"Feb 6, 2015",The SpongeBob Movie: Sponge Out of Water,74,162,311,149,"[adventure, comedy, family, fantasy, animation]"
391,77,"May 20, 2016",The Angry Birds Movie,73,107,352,245,"[animation, adventure, comedy]"
392,90,"Jul 30, 2004",The Village,71,114,257,143,[drama]
393,9,"Mar 22, 2013",Olympus Has Fallen,70,98,172,74,"[action, thriller]"
394,10,"Mar 11, 2011",Battle: Los Angeles,70,83,213,130,"[action, sci-fi]"
395,12,"Dec 25, 2011",War Horse,70,79,156,77,"[drama, war]"
396,14,"Feb 7, 2014",The Monuments Men,70,78,158,80,"[war, drama, history, action]"
397,15,"Sep 23, 2016",Storks,70,72,183,111,"[adventure, animation, comedy, family]"
400,19,"Jan 20, 2012",Underworld: Awakening,70,62,160,98,"[fantasy, action, horror]"
401,20,"Sep 22, 2017",The Lego Ninjago Movie,70,59,122,63,"[action, animation, adventure, family]"
402,21,"Oct 10, 2014",Dracula Untold,70,55,220,165,"[horror, action, drama, fantasy, war]"
405,25,"Jan 14, 2011",The Dilemma,70,48,70,22,"[comedy, drama]"
406,29,"Jun 15, 2012",Rock of Ages,70,38,61,23,"[comedy, drama, music, romance]"
407,34,"Jun 7, 2002",Bad Company,70,30,69,39,[action]
408,36,"Jan 29, 2016",The Finest Hours,70,27,49,22,"[action, drama, history, thriller]"
409,37,"Oct 18, 2013",Escape Plan,70,25,103,78,"[action, thriller]"
410,38,"Sep 23, 2011",Killer Elite,70,25,65,40,"[action, adventure, thriller]"
411,42,"Jan 10, 2014",The Legend of Hercules,70,18,58,40,"[action, adventure]"
412,47,"Jan 16, 2015",Blackhat,70,8,19,11,"[crime, thriller, action]"
413,50,"Jul 9, 2010",Despicable Me,69,251,543,292,"[animation, family, comedy]"
414,51,"Jul 30, 2010",Dinner for Schmucks,69,73,86,13,[comedy]
415,52,"Mar 2, 2018",Red Sparrow,69,46,145,99,"[mystery, thriller]"
416,53,"Jun 30, 2010",The Twilight Saga: Eclipse,68,300,706,406,"[adventure, fantasy, drama, romance]"
417,55,"Jun 26, 2015",Ted 2,68,81,217,136,[comedy]
418,57,"Feb 25, 2011",Hall Pass,68,45,87,42,"[comedy, romance]"
423,65,"Jun 22, 2012",Abraham Lincoln: Vampire Hunter,67,37,137,100,"[action, fantasy, horror]"
424,70,"Mar 14, 2014",Need for Speed,66,43,194,151,"[action, crime, drama, thriller]"
425,72,"Dec 15, 2000",What Women Want,65,182,374,192,"[romance, drama, comedy]"
426,73,"Nov 9, 2012",Lincoln,65,182,273,91,"[history, drama]"
427,75,"Jun 30, 1995",Apollo 13,65,173,335,162,"[drama, history]"
428,77,"Jul 13, 2018",Hotel Transylvania 3: Summer Vacation,65,167,527,360,"[family, fantasy, comedy, animation]"
429,82,"Dec 25, 2014",Unbroken,65,115,163,48,"[drama, war]"
430,84,"Nov 5, 2010",Due Date,65,100,211,111,"[comedy, drama]"
431,89,"Dec 19, 2014",Annie,65,85,139,54,"[comedy, drama, family]"
432,96,"May 16, 2012",The Dictator,65,59,180,121,[comedy]
433,98,"Feb 17, 2012",This Means War,65,54,156,102,"[action, comedy, romance]"
434,99,"Feb 27, 2015",Focus,65,53,168,115,"[romance, comedy, crime, drama]"
435,100,"Dec 8, 2004",Blade: Trinity,65,52,131,79,"[sci-fi, action, horror, thriller, adventure, fantasy]"
436,1,"Nov 21, 2012",Red Dawn,65,44,48,4,"[war, action, thriller, sci-fi]"
439,4,"Sep 14, 2012",Resident Evil: Retribution,65,42,240,198,"[action, horror, sci-fi]"
440,12,"Jan 14, 2005",Elektra,65,24,56,32,[]
441,14,"Jan 24, 2014","I, Frankenstein",65,19,74,55,"[horror, thriller]"
442,16,"Aug 22, 2014",Sin City: A Dame to Kill For,65,13,40,27,"[crime, thriller]"
445,27,"Apr 1, 2011",Hop,63,108,188,80,"[animation, comedy, family]"
446,28,"Sep 15, 2017",American Assassin,63,36,68,32,"[action, thriller]"
449,36,"Oct 3, 2014",Gone Girl,61,167,368,201,"[mystery, thriller, drama]"
450,38,"Sep 18, 2015",Maze Runner: The Scorch Trials,61,81,310,229,"[action, sci-fi, thriller]"
451,39,"Aug 2, 2013",2 Guns,61,75,132,57,"[action, comedy, crime]"
452,40,"Jan 26, 2018",Maze Runner: The Death Cure,61,58,265,207,"[action, sci-fi]"
453,44,"Feb 7, 2014",The Lego Movie,60,257,457,200,"[adventure, animation, comedy, family, fantasy]"
454,50,"Sep 9, 2016",Sully,60,125,238,113,"[drama, history]"
455,51,"Jun 14, 2002",The Bourne Identity,60,121,214,93,"[action, drama, mystery, thriller]"
456,63,"Oct 15, 2010",Red,60,90,196,106,[]
457,67,"Aug 13, 2010",Eat Pray Love,60,80,206,126,[drama]
458,68,"Dec 21, 2012",Jack Reacher,60,80,217,137,"[crime, drama, thriller, action]"
459,69,"Apr 23, 2004",Man on Fire,60,77,130,53,[]
460,71,"Sep 9, 2011",Contagion,60,75,137,62,"[drama, thriller, sci-fi]"
461,80,"Mar 4, 2016",London Has Fallen,60,62,195,133,"[action, thriller]"
462,83,"Nov 22, 1996",Jingle All the Way,60,60,129,69,[animation]
465,86,"May 25, 2017",Baywatch,60,58,175,117,"[action, comedy]"
466,88,"Dec 25, 2015",Joy,60,56,101,45,"[drama, comedy]"
467,89,"Aug 17, 2012",ParaNorman,60,56,108,52,"[family, animation, adventure, comedy]"
470,94,"Sep 26, 2014",The Boxtrolls,60,50,111,61,"[animation, comedy, family, fantasy]"
471,95,"Aug 4, 2017",The Dark Tower,60,50,113,63,"[action, fantasy, sci-fi, western, horror]"
472,97,"Jan 17, 2014",Jack Ryan: Shadow Recruit,60,50,131,81,"[action, drama, thriller]"
475,4,"Jan 11, 2013",Gangster Squad,60,46,104,58,"[crime, drama, action, thriller]"
476,5,"Apr 7, 2017",Smurfs: The Lost Village,60,45,197,152,"[adventure, animation, comedy, family]"
477,6,"Oct 12, 2018",First Man,60,44,105,61,"[history, drama]"
480,15,"Apr 17, 2009",State of Play,60,37,88,51,[documentary]
481,18,"Sep 21, 2012",Trouble with the Curve,60,35,47,12,"[drama, romance]"
482,22,"Sep 15, 2000",Almost Famous,60,32,47,15,"[drama, music]"
483,26,"Aug 21, 2013",The Mortal Instruments: City of Bones,60,31,75,44,"[action, adventure, drama, mystery, romance, fantasy]"
484,29,"May 13, 2011",Priest,60,29,84,55,"[fantasy, horror]"
485,47,"Feb 24, 2017",Rock Dog,60,9,24,15,"[adventure, animation, comedy, family, music]"
486,48,"Jan 23, 2015",Mortdecai,60,7,30,23,"[comedy, adventure]"
487,54,"Mar 23, 2018",Sherlock Gnomes,59,43,87,44,"[romance, animation, comedy, family, fantasy, mystery, adventure]"
488,56,"Feb 12, 2016",Deadpool,58,363,801,438,"[action, adventure, comedy]"
493,61,"Jan 20, 2012",Red Tails,58,49,50,1,"[drama, action, adventure, history, war]"
494,63,"Jun 7, 2013",The Internship,58,44,93,49,[comedy]
495,70,"Sep 10, 2010",Resident Evil: Afterlife,57,60,295,235,"[action, adventure, horror, sci-fi]"
496,71,"Jun 15, 2012",That's My Boy,57,36,58,22,[comedy]
497,73,"Feb 17, 2012",Ghost Rider: Spirit of Vengeance,57,51,149,98,"[action, fantasy, thriller]"
498,77,"Dec 25, 2014",Into the Woods,56,128,213,85,"[fantasy, comedy]"
499,84,"Nov 2, 2018",Bohemian Rhapsody,55,216,894,678,"[drama, music]"
500,91,"Feb 10, 2017",Fifty Shades Darker,55,114,381,267,"[drama, romance]"
501,92,"Oct 11, 2013",Captain Phillips,55,107,220,113,"[action, drama, thriller]"
504,96,"Sep 26, 2014",The Equalizer,55,101,192,91,"[thriller, action, crime]"
505,97,"Feb 9, 2018",Fifty Shades Freed,55,100,371,271,"[drama, romance]"
506,99,"Apr 9, 2010",Date Night,55,98,152,54,[comedy]
507,5,"Jan 16, 2015",Paddington,55,76,258,182,"[comedy, adventure, family]"
508,15,"Mar 15, 1996",Executive Decision,55,56,122,66,"[action, adventure, drama, thriller]"
509,16,"Nov 1, 2013",Free Birds,55,55,110,55,"[animation, comedy, family]"
510,20,"Mar 21, 2014",Muppets Most Wanted,55,51,79,28,"[comedy, adventure, crime, family]"
511,22,"Aug 19, 2016",Kubo and the Two Strings,55,48,77,29,"[animation, adventure, family]"
512,24,"Nov 24, 2010",Burlesque,55,39,90,51,"[drama, romance]"
513,27,"Jul 27, 2012",The Watch,55,34,67,33,"[action, comedy, sci-fi]"
514,28,"Mar 14, 2003",The Hunted,55,34,47,13,[thriller]
515,32,"Feb 23, 2018",Annihilation,55,32,43,11,[sci-fi]
518,42,"Feb 1, 2013",Bullet to the Head,55,9,22,13,"[action, crime, thriller]"
521,66,"Dec 19, 2012",Zero Dark Thirty,52,95,134,39,"[thriller, drama, history]"
522,69,"Jun 2, 2006",The Break-Up,52,118,205,87,"[romance, comedy]"
523,70,"Feb 12, 2010",Valentine's Day,52,110,217,107,"[comedy, romance]"
524,72,"Aug 5, 2011",The Change-Up,52,37,75,38,[comedy]
527,80,"Nov 22, 2006",Deck the Halls,51,35,46,11,"[action, drama, mystery, tv movie]"
528,81,"Mar 4, 2011",The Adjustment Bureau,50,62,126,64,"[sci-fi, thriller, romance]"
529,84,"Jun 29, 2012",Ted,50,218,556,338,"[comedy, fantasy]"
530,85,"Jun 13, 2014",22 Jump Street,50,191,331,140,"[crime, comedy, action]"
531,91,"Jun 17, 2016",Central Intelligence,50,127,217,90,"[action, comedy, mystery]"
532,92,"Dec 18, 2013",Anchorman 2: The Legend Continues,50,127,172,45,[comedy]
533,93,"Jun 10, 2011",Super 8,50,127,257,130,"[thriller, sci-fi, mystery]"
534,96,"Nov 21, 2018",Creed II,50,115,213,98,[drama]
535,97,"Feb 9, 2018",Peter Rabbit,50,115,347,232,"[animation, adventure, family]"
540,7,"Jul 28, 2017",The Emoji Movie,50,86,216,130,"[animation, family, comedy]"
543,10,"Feb 5, 1999",Payback,50,81,161,80,[documentary]
544,14,"Dec 23, 2011",We Bought a Zoo,50,75,118,43,"[drama, comedy, family]"
545,15,"Sep 23, 2011",Moneyball,50,75,111,36,[drama]
546,26,"Apr 6, 2012",American Reunion,50,56,236,180,[comedy]
547,27,"Jan 25, 2013",Hansel & Gretel: Witch Hunters,50,55,214,159,"[fantasy, horror, action]"
548,30,"Jan 15, 2016",13 Hours: The Secret Soldiers of Benghazi,50,52,69,17,"[action, drama, history, thriller, war]"
551,35,"Oct 17, 2014",The Book of Life,50,50,97,47,"[romance, animation, adventure, comedy, family, fantasy]"
552,40,"Aug 8, 2014",Into the Storm,50,47,150,103,"[action, thriller]"
555,45,"Aug 19, 2016",War Dogs,50,43,86,43,"[comedy, crime, drama]"
556,56,"May 20, 2016",The Nice Guys,50,36,59,23,"[comedy, crime, mystery]"
557,59,"Jun 4, 2010",Marmaduke,50,33,89,56,"[family, comedy]"
558,61,"Oct 15, 2010",Hereafter,50,32,108,76,"[drama, fantasy]"
561,64,"Feb 12, 2016",Zoolander 2,50,28,55,27,[comedy]
562,68,"Mar 29, 2013",The Host,50,26,64,38,"[action, adventure, romance, sci-fi, thriller]"
563,70,"Mar 13, 2015",Run All Night,50,26,66,40,"[action, drama, thriller]"
564,74,"Feb 27, 2004",Twisted,50,25,40,15,"[thriller, tv movie]"
567,79,"Sep 16, 2016",Snowden,50,21,35,14,"[drama, history, crime, thriller]"
568,80,"Sep 30, 2011",Dream House,50,21,41,20,"[drama, thriller, mystery]"
569,81,"Jun 24, 2016",Free State of Jones,50,20,23,3,"[action, drama, history, war]"
570,85,"Feb 14, 2013",Beautiful Creatures,50,19,60,41,"[fantasy, drama, romance]"
571,90,"Nov 3, 1995",Fair Game,50,11,26,15,"[drama, thriller]"
572,91,"Feb 25, 2011",Drive Angry,50,10,41,31,"[fantasy, thriller, action, crime]"
573,98,"Feb 16, 2018",Early Man,50,8,45,37,"[family, comedy, animation, adventure]"
574,2,"Apr 17, 2015",Child 44,50,1,8,7,"[crime, thriller]"
577,11,"Mar 6, 2015",Chappie,49,31,105,74,"[crime, action, sci-fi]"
578,13,"Nov 16, 2012",Anna Karenina,49,12,71,59,"[drama, romance]"
579,18,"Jan 9, 2015",Taken 3,48,89,327,238,"[thriller, action]"
580,20,"Nov 16, 2018",Instant Family,48,67,119,52,"[comedy, drama]"
581,23,"Jan 22, 2010",Tooth Fairy,48,60,112,52,"[comedy, family, fantasy]"
582,32,"Jul 13, 2016",The Infiltrator,47,15,20,5,"[crime, drama, thriller]"
585,40,"Jun 18, 2010",Jonah Hex,47,10,11,1,"[action, western, drama, fantasy, thriller]"
588,44,"Jun 20, 1997",My Best Friend's Wedding,46,126,298,172,"[comedy, romance]"
589,47,"May 24, 2002",Insomnia,46,67,113,46,[]
590,48,"Sep 20, 2013",Prisoners,46,61,113,52,"[drama, thriller, crime]"
591,54,"Oct 5, 2012",Taken 2,45,139,377,238,"[action, crime, thriller]"
594,64,"Nov 23, 2011",The Muppets,45,88,160,72,"[comedy, family, music]"
598,71,"Aug 21, 1998",Blade,45,70,131,61,"[horror, action]"
599,73,"Mar 19, 2010",The Bounty Hunter,45,67,135,68,"[action, comedy, drama]"
600,81,"Dec 9, 2016",Office Christmas Party,45,54,91,37,[comedy]
601,88,"Jul 6, 2012",Savages,45,47,82,35,"[crime, drama, thriller]"
602,90,"May 23, 2014",Blended,45,46,127,81,[comedy]
603,91,"Jun 16, 2017",All Eyez on Me,45,44,54,10,"[drama, music]"
604,3,"Nov 4, 1994",Frankenstein,45,22,112,90,"[horror, thriller]"
605,7,"Jan 19, 2001",The Pledge,45,19,29,10,[drama]
606,10,"Jul 1, 2005",Rebound,45,16,17,1,"[thriller, horror]"
607,11,"Feb 19, 2010",The Ghost Writer,45,15,65,50,"[thriller, mystery]"
608,15,"Sep 21, 2012",Dredd,45,13,41,28,"[action, sci-fi]"
609,16,"Oct 28, 2011",The Rum Diary,45,13,21,8,"[drama, comedy]"
610,18,"Dec 21, 2018",Welcome to Marwen,45,10,12,2,"[drama, comedy, fantasy]"
611,19,"Oct 21, 2011",Johnny English Reborn,45,8,164,156,"[crime, adventure, action, comedy, thriller]"
612,27,"Oct 12, 2012",Argo,44,136,227,91,"[drama, thriller]"
613,31,"Jul 30, 2010",Charlie St. Cloud,44,31,48,17,"[drama, romance]"
614,33,"Feb 6, 2014",The Interview,44,6,12,6,"[action, comedy]"
615,35,"Jun 28, 2013",The Heat,43,159,229,70,"[action, comedy, crime]"
618,42,"Jan 28, 2011",The Mechanic,42,29,76,47,"[action, thriller, crime]"
619,44,"Mar 16, 2012",21 Jump Street,42,138,202,64,"[action, comedy, crime]"
622,52,"Oct 12, 2012",Here Comes the Boom,42,45,73,28,"[action, comedy]"
623,55,"Mar 11, 2011",Red Riding Hood,42,37,91,54,"[fantasy, thriller, horror]"
624,58,"Dec 25, 2018",Holmes & Watson,42,30,41,11,"[mystery, adventure, comedy, crime]"
625,59,"Jan 27, 2012",One for the Money,42,26,36,10,"[action, comedy, crime]"
629,64,"Jan 27, 2012",Man on a Ledge,42,18,49,31,"[action, thriller, crime]"
630,65,"Dec 3, 2010",The Warrior's Way,42,5,8,3,"[adventure, fantasy, action, western, thriller]"
631,77,"Jun 11, 2010",The Karate Kid,40,176,351,175,"[action, adventure, drama, family]"
632,78,"Feb 13, 2015",Fifty Shades of Grey,40,166,570,404,"[drama, romance, thriller]"
635,83,"Jul 25, 2014",Lucy,40,126,457,331,"[action, sci-fi]"
636,84,"Dec 25, 2013",Lone Survivor,40,125,149,24,"[action, drama, war]"
637,91,"Oct 1, 2010",The Social Network,40,96,224,128,[drama]
638,95,"Jan 15, 2016",Ride Along 2,40,90,124,34,"[action, comedy]"
639,97,"Mar 27, 2015",Get Hard,40,90,106,16,[comedy]
642,1,"Nov 14, 2014",Dumb and Dumber To,40,86,156,70,[comedy]
646,6,"Sep 25, 2015",The Intern,40,75,197,122,[comedy]
649,12,"Mar 20, 2009","I Love You, Man",40,72,92,20,[comedy]
652,21,"Feb 18, 2011",Unknown,40,63,136,73,"[action, mystery, thriller]"
653,22,"Jun 4, 2010",Get Him to the Greek,40,61,91,30,[comedy]
654,25,"Mar 18, 2011",The Lincoln Lawyer,40,58,87,29,"[crime, drama, thriller]"
655,30,"Jul 31, 1997",Spawn,40,54,87,33,[horror]
656,31,"Nov 26, 2014",Horrible Bosses 2,40,54,105,51,[comedy]
657,35,"Jul 9, 2010",Predators,40,52,127,75,"[action, sci-fi, adventure, thriller]"
658,36,"Aug 15, 2012",The Odd Life of Timothy Green,40,51,55,4,"[fantasy, drama, comedy, family]"
659,43,"Jun 20, 2014",Jersey Boys,40,47,65,18,"[music, drama]"
660,49,"Aug 12, 2011",Final Destination 5,40,42,155,113,"[horror, mystery]"
661,50,"Nov 16, 2018",Widows,40,42,73,31,"[crime, thriller]"
662,54,"Jul 18, 2014",Sex Tape,40,38,126,88,[comedy]
663,55,"Apr 15, 2011",Scream 4,40,38,95,57,"[horror, mystery]"
664,58,"Mar 18, 2011",Paul,40,37,101,64,"[adventure, comedy, sci-fi]"
665,59,"Dec 19, 2012",The Guilt Trip,40,37,41,4,[comedy]
666,60,"Aug 26, 2011",Colombiana,40,36,72,36,"[action, thriller, crime, drama]"
667,62,"Jan 12, 2018",The Commuter,40,36,101,65,"[action, thriller]"
668,67,"Apr 8, 2011",Arthur,40,33,47,14,"[comedy, romance]"
671,73,"Nov 10, 2010",Morning Glory,40,31,59,28,"[comedy, drama, romance]"
672,75,"May 3, 2019",Long Shot,40,30,43,13,[documentary]
673,77,"Dec 25, 2013",Grudge Match,40,29,69,40,[comedy]
674,81,"Aug 11, 2017",The Nut Job 2: Nutty by Nature,40,28,57,29,"[family, animation, adventure, comedy]"
675,84,"Jan 27, 2017",Resident Evil: The Final Chapter,40,26,314,288,"[action, horror, sci-fi]"
676,86,"Jun 30, 2017",The House,40,25,31,6,[comedy]
677,89,"Jan 7, 2011",Season of the Witch,40,24,91,67,"[adventure, fantasy, action]"
678,94,"Aug 26, 2016",Mechanic: Resurrection,40,21,109,88,"[action, crime, thriller]"
679,99,"Feb 3, 2012",Big Miracle,40,20,25,5,"[adventure, drama, romance]"
680,100,"Dec 21, 2012",The Impossible,40,19,169,150,"[thriller, drama]"
681,1,"Mar 9, 2012",A Thousand Words,40,18,20,2,"[drama, comedy]"
682,15,"Mar 20, 2015",The Gunman,40,10,18,8,"[action, drama, crime]"
687,22,"Mar 9, 2018",The Hurricane Heist,40,6,30,24,"[action, crime, thriller]"
690,27,"Jun 27, 2014",Snowpiercer,40,4,88,84,"[action, sci-fi, drama]"
691,48,"Oct 5, 2012",Frankenweenie,39,35,81,46,"[animation, comedy, family]"
692,54,"Jun 22, 2001",The Fast and the Furious,38,144,206,62,"[action, crime, thriller]"
693,59,"Jun 2, 2017",Captain Underpants: The First Epic Movie,38,73,126,53,"[action, animation, comedy, family]"
694,60,"Apr 17, 2015",Paul Blart: Mall Cop 2,38,71,107,36,"[action, comedy, family]"
697,63,"Apr 22, 2011",Water for Elephants,38,58,116,58,"[drama, romance]"
698,66,"Sep 6, 2013",Riddick,38,42,94,52,"[sci-fi, action, thriller]"
699,68,"May 24, 2002",Enough,38,39,50,11,"[comedy, animation]"
700,69,"Jan 22, 2016",The 5th Wave,38,34,111,77,"[adventure, sci-fi]"
701,71,"Sep 20, 2013",Rush,38,26,98,72,"[drama, action]"
702,75,"Oct 20, 2017",Only the Brave,38,18,24,6,[drama]
703,77,"Oct 14, 2011",The Thing,38,16,27,11,"[horror, sci-fi, mystery, thriller]"
704,82,"Sep 21, 2018",The Sisters Brothers,38,3,13,10,"[comedy, drama, western]"
705,85,"Jan 11, 2019",The Upside,37,108,119,11,"[comedy, drama]"
706,86,"May 18, 2012",What to Expect When You're Expecting,37,41,88,47,"[romance, comedy, drama]"
709,90,"Aug 7, 2013",We're the Millers,37,150,267,117,"[comedy, crime]"
712,92,"Sep 17, 2010",The Town,37,92,152,60,"[crime, drama, thriller]"
713,93,"Sep 23, 2011",Dolphin Tale,37,72,96,24,"[drama, family]"
714,94,"Feb 23, 2018",Game Night,37,69,117,48,"[mystery, comedy, crime]"
715,99,"Feb 26, 2010",Cop Out,37,44,55,11,"[action, comedy, crime]"
716,100,"Jan 28, 2011",The Rite,37,33,97,64,"[drama, thriller, horror]"
717,3,"May 29, 2015",Aloha,37,21,25,4,"[drama, comedy, romance]"
718,10,"Mar 26, 2010",Hot Tub Time Machine,36,50,65,15,"[sci-fi, comedy, adventure]"
719,12,"Sep 12, 2014",Dolphin Tale 2,36,42,57,15,"[family, drama]"
722,21,"May 6, 2011",There Be Dragons,36,1,4,3,"[drama, war]"
725,29,"Dec 22, 2010",True Grit,35,171,252,81,"[drama, adventure, western]"
726,32,"Feb 8, 2013",Identity Thief,35,134,175,41,"[comedy, crime]"
727,34,"Jul 8, 2011",Horrible Bosses,35,117,212,95,"[comedy, crime]"
728,36,"Jul 17, 2015",Trainwreck,35,110,141,31,"[comedy, romance]"
729,37,"Dec 13, 2013",Saving Mr. Banks,35,83,114,31,"[comedy, drama, history]"
730,49,"Apr 30, 2010",A Nightmare on Elm Street,35,63,117,54,"[horror, mystery, thriller]"
731,53,"Oct 8, 2010",Secretariat,35,59,60,1,[drama]
732,55,"Jul 22, 2011",Friends with Benefits,35,55,146,91,"[romance, comedy]"
733,56,"May 20, 2016",Neighbors 2: Sorority Rising,35,55,108,53,[comedy]
734,59,"Jun 29, 2018",Sicario: Day of the Soldado,35,50,75,25,"[action, crime, drama, thriller]"
737,63,"Oct 12, 2018",Goosebumps 2: Haunted Halloween,35,46,93,47,"[adventure, comedy, fantasy, family, horror]"
738,64,"Jan 19, 2018",12 Strong,35,45,71,26,"[war, drama, history, action]"
739,72,"May 6, 2011",Something Borrowed,35,39,65,26,"[comedy, drama, romance]"
740,74,"Oct 28, 2011",In Time,35,37,165,128,"[action, thriller, sci-fi]"
741,76,"Nov 9, 2011",J. Edgar,35,37,84,47,"[drama, crime, history]"
742,78,"Aug 17, 2018",Mile 22,35,36,66,30,[action]
743,79,"May 8, 2015",Hot Pursuit,35,34,45,11,"[action, comedy, crime]"
750,91,"Jan 6, 2017",Underworld: Blood Wars,35,30,81,51,"[action, fantasy, horror, drama]"
751,93,"Aug 20, 2010",Nanny McPhee and the Big Bang,35,29,97,68,"[comedy, fantasy, family]"
752,96,"Sep 23, 2011",Abduction,35,28,86,58,"[thriller, action, mystery]"
753,100,"Oct 19, 2012",Alex Cross,35,25,35,10,"[action, thriller, crime, mystery]"
756,6,"Mar 4, 2016",Whiskey Tango Foxtrot,35,23,25,2,"[war, comedy]"
757,8,"Aug 21, 2015",Hitman: Agent 47,35,22,82,60,"[action, crime, thriller]"
758,10,"Aug 24, 2012",Premium Rush,35,20,31,11,"[crime, action, thriller]"
759,11,"Jan 18, 2013",Broken City,35,19,34,15,"[thriller, crime, drama]"
760,14,"Feb 25, 2005",Cursed,35,19,25,6,"[animation, comedy]"
761,17,"Apr 30, 2010",Furry Vengeance,35,17,39,22,"[comedy, family]"
762,18,"Jan 25, 2013",Parker,35,17,48,31,"[action, crime]"
763,24,"May 27, 2011",The Tree of Life,35,13,61,48,"[drama, fantasy]"
764,26,"Aug 11, 2006",Zoom,35,11,12,1,"[animation, comedy, drama]"
765,29,"Mar 28, 2014",Sabotage,35,10,18,8,"[action, drama, thriller, crime]"
766,32,"Mar 6, 2015",Unfinished Business,35,10,13,3,[comedy]
767,33,"Sep 30, 2015",The Walk,35,10,61,51,"[adventure, drama, thriller]"
768,35,"Nov 29, 2013",Mandela: Long Walk to Freedom,35,8,29,21,"[drama, history]"
769,40,"Oct 20, 2017",The Snowman,35,6,43,37,"[drama, crime, thriller, horror]"
770,44,"Jan 28, 2011",Biutiful,35,5,24,19,[drama]
771,47,"Apr 22, 2016",A Hologram for the King,35,4,11,7,"[comedy, drama]"
772,58,"Dec 25, 2011",The Darkest Hour,34,21,62,41,"[horror, action, thriller, sci-fi]"
773,59,"Jun 28, 2017",Baby Driver,34,107,228,121,"[action, crime]"
774,60,"Sep 19, 2014",The Maze Runner,34,102,348,246,"[action, mystery, sci-fi, thriller]"
775,61,"Apr 10, 2015",The Longest Ride,34,37,63,26,"[drama, romance]"
776,64,"Aug 3, 2018",The Darkest Minds,34,12,38,26,"[sci-fi, thriller]"
777,73,"Jul 8, 2016",Mike and Dave Need Wedding Dates,33,46,75,29,[comedy]
778,74,"Jul 27, 2012",Step Up Revolution,33,35,165,130,"[music, drama, romance]"
779,77,"Sep 8, 2000",The Watcher,33,28,47,19,"[horror, thriller]"
780,78,"Apr 27, 2012",Safe,33,17,41,24,"[action, crime, thriller]"
781,85,"May 13, 2011",Bridesmaids,32,169,289,120,"[comedy, romance]"
782,87,"Apr 26, 2013",The Big Wedding,32,21,48,27,[comedy]
783,88,"Feb 24, 2012",Wanderlust,32,17,24,7,"[comedy, romance]"
784,95,"Aug 27, 2010",Takers,32,57,70,13,"[action, crime, drama, thriller]"
785,96,"Apr 1, 2011",Source Code,32,54,140,86,"[thriller, sci-fi, mystery]"
786,97,"Sep 10, 1999",Stigmata,32,50,89,39,"[drama, fantasy]"
787,99,"Apr 20, 2018",I Feel Pretty,32,48,91,43,[comedy]
788,1,"Feb 18, 2011","Big Mommas: Like Father, Like Son",32,37,82,45,"[crime, comedy, action]"
789,4,"Dec 14, 1979",1941,32,34,94,60,[comedy]
790,7,"Mar 15, 2013",The Incredible Burt Wonderstone,32,22,27,5,[comedy]
791,10,"Oct 12, 2018",Bad Times at the El Royale,32,17,29,12,"[thriller, crime, mystery, drama]"
792,11,"Sep 3, 2010",Going the Distance,32,17,43,26,"[comedy, drama, romance]"
793,13,"Mar 19, 2010",Repo Men,32,13,18,5,"[action, sci-fi, thriller, crime]"
794,21,"Apr 15, 2016",Criminal,31,14,38,24,"[action, crime, sci-fi, thriller, mystery, drama]"
795,22,"Apr 12, 2013",42,31,95,97,2,[drama]
796,23,"Nov 2, 2012",Flight,31,93,160,67,[drama]
797,27,"Mar 7, 2014",The Grand Budapest Hotel,31,59,163,104,"[comedy, drama]"
800,31,"Apr 28, 2000",Frequency,31,44,68,24,"[crime, drama, sci-fi, thriller]"
801,33,"Jan 22, 2010",Extraordinary Measures,31,12,15,3,[drama]
802,34,"Aug 25, 2017",Birth of the Dragon,31,6,7,1,"[action, drama]"
805,38,"Aug 15, 2018",Crazy Rich Asians,30,174,238,64,"[comedy, drama, romance]"
806,42,"Feb 10, 2012",The Vow,30,125,197,72,"[drama, romance]"
807,57,"Dec 18, 2015",Sisters,30,87,106,19,[comedy]
808,69,"Sep 28, 2012",Looper,30,66,170,104,"[action, thriller, sci-fi]"
809,70,"Feb 1, 2013",Warm Bodies,30,66,115,49,"[horror, comedy, romance]"
810,72,"Jan 17, 2014",The Nut Job,30,64,122,58,"[animation, comedy, family, adventure]"
811,75,"Aug 8, 2012",Hope Springs,30,63,133,70,"[drama, comedy, romance]"
812,83,"May 20, 2011",Midnight in Paris,30,56,162,106,"[fantasy, comedy, romance]"
815,88,"May 11, 2018",Life of the Party,30,53,65,12,[comedy]
816,89,"May 14, 2010",Letters to Juliet,30,53,82,29,"[comedy, drama, romance]"
817,92,"Jul 24, 2015",Southpaw,30,52,94,42,"[action, drama]"
818,94,"Jul 28, 2017",Atomic Blonde,30,51,98,47,"[action, mystery, thriller]"
821,3,"Jan 19, 2018",Den of Thieves,30,44,80,36,"[action, thriller, crime]"
822,4,"Apr 13, 2012",The Three Stooges,30,44,54,10,[comedy]
823,6,"Oct 24, 2014",John Wick,30,43,76,33,"[action, thriller]"
824,8,"Apr 24, 2015",The Age of Adaline,30,42,68,26,"[fantasy, drama, romance]"
825,9,"Aug 6, 2010",Step Up 3D,30,42,165,123,"[drama, romance]"
828,14,"Apr 8, 2011",Hanna,30,40,65,25,"[action, thriller, adventure]"
832,23,"Feb 9, 2018",The 15:17 to Paris,30,36,56,20,"[drama, history, thriller]"
833,25,"Jul 1, 2011",Larry Crowne,30,35,61,26,"[comedy, romance, drama]"
836,28,"Mar 2, 2018",Death Wish,30,34,48,14,"[action, crime, drama, thriller]"
837,30,"Jun 3, 2015",Entourage,30,32,46,14,[comedy]
840,34,"Jul 2, 2014",Deliver Us from Evil,30,30,87,57,"[thriller, crime, horror]"
841,35,"Aug 1, 2014",Get on Up,30,30,33,3,"[drama, music]"
842,37,"Apr 27, 2012",The Five-Year Engagement,30,28,61,33,"[romance, comedy]"
843,39,"Jul 15, 2011",Winnie the Pooh,30,26,50,24,"[animation, family]"
844,42,"Sep 14, 2018",White Boy Rick,30,24,25,1,"[crime, drama]"
845,45,"Feb 4, 2011",Sanctum,30,23,108,85,"[action, thriller]"
848,49,"Nov 19, 2010",The Next Three Days,30,21,67,46,"[romance, drama, thriller, crime]"
849,50,"Jan 12, 2018",Proud Mary,30,20,21,1,"[thriller, action, crime]"
850,53,"Oct 4, 2013",Runner Runner,30,19,60,41,"[crime, thriller, drama]"
851,55,"Apr 28, 2017",Baahubali 2: The Conclusion,30,18,263,245,"[action, drama]"
852,58,"Aug 19, 2011",Fright Night,30,18,40,22,"[horror, comedy]"
853,59,"Sep 15, 2017",mother!,30,17,42,25,"[drama, horror, mystery]"
856,74,"Jan 18, 2013",The Last Stand,30,12,48,36,"[action, crime, thriller]"
857,78,"Mar 8, 2013",Dead Man Down,30,10,19,9,"[thriller, action, crime, drama]"
860,84,"Feb 3, 2017",The Space Between Us,30,7,16,9,"[romance, adventure, sci-fi, drama]"
863,88,"Aug 31, 2018",Kin,30,5,10,5,"[sci-fi, action]"
864,90,"Sep 22, 2017",Stronger,30,4,8,4,[drama]
865,13,"Feb 24, 2017",Collide,29,2,5,3,"[thriller, action]"
866,14,"May 15, 2015",Pitch Perfect 2,29,184,287,103,"[comedy, music]"
869,17,"Apr 8, 2016",The Boss,29,63,78,15,[comedy]
870,21,"Aug 18, 2017",Logan Lucky,29,27,44,17,"[action, comedy, crime, drama]"
871,22,"Aug 12, 2016",Florence Foster Jenkins,29,27,56,29,"[comedy, drama]"
874,36,"Jul 21, 2017",Girls Trip,28,115,140,25,[comedy]
877,41,"Feb 14, 2013",Safe Haven,28,71,94,23,[romance]
878,42,"Dec 11, 2015",The Big Short,28,70,133,63,"[comedy, drama]"
879,44,"Oct 10, 2014","Alexander and the Terrible, Horrible, No Good, Very Bad Day",28,66,101,35,"[family, comedy]"
880,46,"Jan 28, 2013",Last Vegas,28,63,112,49,[comedy]
883,52,"Apr 25, 2003",Identity,28,52,82,30,[drama]
884,54,"Apr 16, 2010",Kick-Ass,28,48,97,49,"[action, crime]"
885,60,"Aug 12, 2011",30 Minutes or Less,28,37,40,3,"[action, adventure, comedy]"
886,64,"Feb 21, 2014",3 Days to Kill,28,30,38,8,"[action, drama, thriller, crime]"
887,65,"Aug 16, 2013",Kick-Ass 2,28,28,63,35,"[action, adventure, crime]"
888,67,"Sep 19, 2014",A Walk Among the Tombstones,28,26,62,36,"[crime, drama, mystery, thriller]"
889,68,"Jan 15, 2010",The Spy Next Door,28,24,46,22,"[action, comedy, family]"
890,69,"Apr 25, 2014",Brick Mansions,28,20,73,53,"[action, crime, drama]"
891,72,"Aug 21, 2015",American Ultra,28,14,30,16,"[comedy, action]"
892,74,"Feb 5, 2016",Pride and Prejudice and Zombies,28,10,16,6,"[romance, horror, comedy, thriller]"
893,86,"Jan 13, 2012",Joyful Noise,27,30,31,1,"[comedy, music]"
894,90,"Oct 28, 2011",Anonymous,27,4,15,11,"[drama, history, thriller]"
895,91,"Mar 18, 2011",Limitless,27,79,155,76,"[thriller, mystery, sci-fi]"
896,98,"May 13, 2016",Money Monster,27,41,93,52,"[thriller, drama]"
897,100,"Aug 19, 2011",Spy Kids: All the Time in the World,27,38,80,42,"[family, comedy, action]"
898,21,"Aug 6, 2003",Freaky Friday,26,110,160,50,"[music, family, fantasy, tv movie, comedy]"
899,30,"Aug 19, 2005",Red Eye,26,57,96,39,[horror]
900,33,"Apr 26, 2013",Pain & Gain,26,49,81,32,"[thriller, crime, action, comedy]"
903,38,"Aug 29, 2012",Lawless,26,37,54,17,"[crime, drama]"
906,42,"Oct 17, 2014",The Best of Me,26,26,41,15,"[drama, romance]"
909,50,"Oct 18, 2013",The Fifth Estate,26,3,6,3,"[drama, thriller]"
910,63,"Aug 10, 2011",The Help,25,169,213,44,[drama]
913,67,"Jan 17, 2014",Ride Along,25,134,153,19,"[action, comedy]"
914,77,"Feb 5, 2010",Dear John,25,80,142,62,"[drama, romance, war]"
915,79,"Dec 25, 2012",Parental Guidance,25,77,120,43,[comedy]
916,84,"Jan 21, 2011",No Strings Attached,25,70,149,79,"[comedy, romance]"
917,85,"Jan 13, 2012",Contraband,25,66,98,32,"[thriller, action, drama, crime]"
918,87,"Apr 20, 2012",The Lucky One,25,60,96,36,"[drama, romance]"
919,92,"Apr 22, 2011",Madea's Big Happy Family,25,53,54,1,"[comedy, drama]"
924,2,"Aug 15, 2014",The Giver,25,45,66,21,"[drama, sci-fi]"
929,17,"May 16, 2014",Million Dollar Arm,25,36,39,3,[drama]
930,21,"Sep 7, 2018",Peppermint,25,35,51,16,"[thriller, action, drama]"
931,25,"Dec 10, 2014",The Gambler,25,33,38,5,"[thriller, crime, drama]"
932,29,"Feb 17, 2017",Fist Fight,25,32,40,8,[comedy]
933,32,"Dec 9, 2011",The Sitter,25,30,38,8,[comedy]
934,36,"Apr 11, 2014",Draft Day,25,28,29,1,[drama]
935,38,"Feb 3, 2017",Rings,25,27,82,55,[horror]
936,43,"Aug 26, 2011",Don't Be Afraid of the Dark,25,24,39,15,"[fantasy, horror, thriller]"
937,44,"Apr 23, 2010",The Losers,25,23,29,6,"[action, adventure, crime, mystery, thriller]"
938,46,"Aug 24, 2007",War,25,22,40,18,"[action, crime, thriller]"
939,50,"Feb 11, 2011",The Eagle,25,19,38,19,"[adventure, drama]"
940,53,"Mar 24, 2017",CHiPS,25,18,23,5,"[action, comedy, crime]"
943,58,"Oct 25, 2013",The Counselor,25,16,71,55,"[thriller, crime, drama]"
944,60,"Dec 7, 2018",Mary Queen of Scots,25,16,46,30,"[drama, history]"
960,68,"Oct 8, 2010",My Soul to Take,25,14,16,2,"[drama, horror, mystery, thriller]"
961,74,"Sep 9, 2011",Warrior,25,13,24,11,[drama]
965,77,"Dec 21, 2012",Cirque du Soleil: Worlds Away,25,12,28,16,"[fantasy, family, music, drama]"
966,78,"Nov 13, 2015",The 33,25,12,28,16,"[drama, history]"
967,80,"Apr 15, 2011",The Conspirator,25,11,15,4,"[crime, drama, history]"
968,88,"Sep 16, 2011",Straw Dogs,25,10,11,1,"[drama, thriller]"
969,94,"Nov 25, 2009",The Road,25,8,29,21,"[crime, horror, thriller]"
972,2,"Apr 25, 2008",Deception,25,4,12,8,[]
973,7,"Dec 16, 2011",Carnage,25,2,38,36,"[comedy, drama]"
974,8,"Sep 1, 2017",Tulip Fever,25,2,6,4,"[drama, romance]"
975,12,"Jan 29, 2016",Jane Got a Gun,25,1,3,2,"[action, drama, western]"
976,36,"Jun 20, 2014",Think Like a Man Too,24,65,70,5,"[comedy, romance]"
979,39,"Oct 14, 2011",Footloose,24,51,62,11,"[drama, music, romance]"
980,40,"Apr 7, 2017",Going in Style,24,45,78,33,"[crime, comedy]"
981,52,"Aug 20, 2010",Piranha 3D,24,25,83,58,"[comedy, horror]"
982,53,"Nov 24, 2010",Faster,24,23,35,12,"[crime, drama, action, thriller]"
983,58,"Sep 16, 2011",I Don't Know How She Does It,24,9,24,15,"[romance, comedy]"
984,60,"Dec 20, 2013",Dhoom 3,24,8,11,3,"[action, thriller]"
985,71,"Nov 16, 2018",Green Book,23,85,322,237,"[drama, comedy]"
988,73,"Jan 16, 2015",The Wedding Ringer,23,64,80,16,[comedy]
989,76,"Oct 7, 2011",The Ides of March,23,40,77,37,[drama]
990,78,"Oct 5, 2018",The Hate U Give,23,29,35,6,"[crime, drama]"
993,83,"Jan 20, 2012",Haywire,23,18,36,18,"[action, thriller, mystery]"
994,86,"Feb 26, 2016",Eddie the Eagle,23,15,45,30,"[comedy, drama, history, adventure]"
997,4,"Apr 24, 2015",The Water Diviner,22,4,31,27,"[war, drama]"
998,5,"Jul 13, 1990",Ghost,22,217,517,300,"[family, comedy]"
999,11,"Feb 28, 2014",Son of God,22,59,70,11,[drama]
1000,13,"Aug 8, 2014",The Hundred-Foot Journey,22,54,94,40,[drama]
1001,17,"Aug 3, 2012",Diary of a Wimpy Kid: Dog Days,22,49,77,28,"[comedy, family]"
1002,19,"Nov 11, 2005",Derailed,22,36,57,21,"[drama, thriller]"
1003,21,"Nov 22, 2013",Delivery Man,22,30,70,40,[comedy]
1004,22,"Feb 5, 2016","Hail, Caesar!",22,30,64,34,"[comedy, drama, mystery]"
1005,27,"May 19, 2017",Diary of a Wimpy Kid: The Long Haul,22,20,35,15,"[comedy, family]"
1006,29,"Nov 27, 2013",Homefront,22,20,51,31,"[action, thriller]"
1007,34,"Sep 4, 2015",The Transporter Refueled,22,16,69,53,"[thriller, action, crime, mystery]"
1008,37,"Aug 22, 2012",Hit & Run,22,13,17,4,"[action, comedy, romance]"
1011,41,"Dec 4, 2013",Out of the Furnace,22,11,15,4,"[thriller, drama, crime]"
1012,49,"Oct 31, 2014",Before I Go to Sleep,22,3,19,16,"[mystery, thriller]"
1015,58,"Jun 22, 2012",To Rome with Love,21,16,74,58,"[romance, comedy, drama]"
1016,59,"Nov 16, 2012",Silver Linings Playbook,21,132,236,104,"[drama, comedy, romance]"
1017,60,"Apr 6, 2018",Blockers,21,60,94,34,[comedy]
1020,67,"Nov 5, 2010",For Colored Girls,21,37,38,1,[drama]
1021,69,"Aug 4, 2017",Kidnap,21,30,34,4,"[drama, thriller]"
1022,72,"Dec 9, 2011",Tinker Tailor Soldier Spy,21,24,81,57,"[drama, thriller, mystery]"
1023,90,"Nov 16, 1977",Close Encounters of the Third Kind,20,169,340,171,"[sci-fi, drama]"
1026,93,"Jul 19, 2013",The Conjuring,20,137,318,181,"[horror, thriller]"
1029,98,"Oct 15, 2010",Jackass 3D,20,117,171,54,"[comedy, documentary, action]"
1030,99,"Jul 29, 2016",Bad Moms,20,113,180,67,[comedy]
1031,3,"Jul 2, 2014",Tammy,20,84,96,12,[comedy]
1032,5,"Nov 16, 2011",The Descendants,20,82,175,93,"[comedy, drama]"
1033,15,"Mar 31, 2010",The Last Song,20,62,92,30,"[drama, family, romance]"
1034,18,"Oct 18, 2013",12 Years a Slave,20,56,181,125,"[drama, history]"
1035,20,"Jun 3, 2016",Me Before You,20,56,208,152,"[drama, romance]"
1036,24,"Sep 14, 2018",A Simple Favor,20,53,97,44,"[thriller, crime, mystery, comedy, drama]"
1037,25,"Jan 9, 2015",Selma,20,52,66,14,"[history, drama]"
1038,30,"Mar 16, 2007",Premonition,20,47,81,34,[]
1039,32,"Feb 4, 2005",Boogeyman,20,46,67,21,[horror]
1043,35,"Mar 30, 2018",Acrimony,20,43,46,3,"[drama, thriller]"
1044,36,"Jun 26, 2015",Max,20,42,43,1,"[adventure, drama, family]"
1045,39,"Nov 17, 2017",The Star,20,40,62,22,"[comedy, adventure, family, fantasy, animation]"
1049,48,"Feb 19, 2016",Risen,20,36,46,10,"[drama, history]"
1050,49,"Aug 18, 2010",Vampires Suck,20,36,81,45,"[comedy, horror]"
1051,51,"Sep 1, 2010",The American,20,35,67,32,"[crime, drama, thriller]"
1052,55,"Jan 4, 2013",Texas Chainsaw 3D,20,34,47,13,"[horror, thriller]"
1053,62,"Mar 12, 2010",She's Out of My League,20,32,48,16,"[comedy, romance]"
1057,65,"Aug 31, 2011",The Debt,20,31,46,15,"[drama, thriller]"
1058,76,"Aug 23, 2013",The World's End,20,26,47,21,"[comedy, action, sci-fi]"
1059,78,"Sep 24, 2010",You Again,20,25,32,7,"[comedy, romance]"
1060,81,"Dec 25, 2018",On the Basis of Sex,20,24,38,14,"[drama, history]"
1061,82,"Feb 14, 2014",Endless Love,20,23,34,11,"[drama, romance]"
1062,83,"Sep 8, 2006",The Covenant,20,23,38,15,[horror]
1063,84,"Jul 1, 2011",Monte Carlo,20,23,39,16,"[adventure, comedy, romance]"
1064,87,"Jun 16, 2017",Rough Night,20,22,46,24,"[drama, comedy]"
1067,5,"Oct 26, 2012",Silent Hill: Revelation 3D,20,17,55,38,"[thriller, horror, mystery]"
1068,11,"Sep 29, 2017",Flatliners,20,16,45,29,"[drama, sci-fi]"
1069,22,"Apr 13, 2012",Lockout,20,14,33,19,"[action, thriller, sci-fi]"
1070,24,"Sep 30, 2011",What's Your Number?,20,14,30,16,"[comedy, romance]"
1073,33,"Feb 26, 2016",Triple 9,20,12,25,13,"[action, thriller, mystery]"
1074,34,"Sep 2, 2016",The Light Between Oceans,20,12,22,10,"[drama, romance]"
1077,51,"Sep 20, 2013",Battle of the Year,20,8,16,8,"[music, drama]"
1080,58,"Oct 11, 2013",Machete Kills,20,8,18,10,"[action, crime, thriller]"
1081,65,"Apr 24, 2015",Little Boy,20,6,17,11,"[comedy, drama, war]"
1082,67,"Oct 26, 2012",Chasing Mavericks,20,6,8,2,[drama]
1085,69,"Nov 23, 2011",A Dangerous Method,20,5,14,9,"[drama, thriller]"
1086,74,"Aug 26, 2016",Hands of Stone,20,4,5,1,[drama]
1087,78,"Sep 7, 2012",The Cold Light of Day,20,3,25,22,"[action, thriller, mystery]"
1088,81,"Oct 26, 2018",Suspiria,20,2,7,5,"[horror, fantasy]"
1091,90,"Apr 29, 2011",Dylan Dog: Dead of Night,20,1,6,5,"[action, comedy, horror, mystery, sci-fi, thriller]"
1094,23,"Jul 29, 2011",The Devil's Double,19,1,5,4,"[drama, action, thriller, crime, war]"
1095,27,"Jun 24, 2011",Bad Teacher,19,100,215,115,[comedy]
1096,28,"Aug 12, 2016",Sausage Party,19,97,141,44,"[adventure, animation, comedy, fantasy]"
1097,36,"Feb 26, 2010",The Crazies,19,39,56,17,"[mystery, horror, action]"
1098,39,"Aug 20, 2010",The Switch,19,27,49,22,"[comedy, romance, drama]"
1101,41,"Nov 8, 2013",The Book Thief,19,21,76,55,[drama]
1102,48,"Mar 4, 2011",Take Me Home Tonight,19,6,7,1,"[comedy, drama, romance]"
1103,64,"May 9, 2014",Neighbors,18,150,270,120,[comedy]
1106,77,"Mar 25, 2016",My Big Fat Greek Wedding 2,18,59,92,33,"[romance, comedy, family]"
1107,78,"Sep 11, 2015",The Perfect Guy,18,57,60,3,"[drama, thriller]"
1108,80,"Mar 25, 2011",Diary of a Wimpy Kid: Rodrick Rules,18,52,73,21,"[family, comedy]"
1109,83,"Apr 8, 2011",Soul Surfer,18,43,47,4,"[family, action, drama]"
1110,85,"Jun 29, 2018",Uncle Drew,18,42,46,4,[comedy]
1111,90,"Jul 26, 2013",Blue Jasmine,18,33,102,69,"[comedy, drama]"
1112,92,"Dec 5, 2003",Honey,18,30,62,32,[drama]
1113,93,"Oct 14, 2005",The Fog,18,29,37,8,"[drama, war, sci-fi]"
1114,95,"Aug 7, 2015",Ricki and the Flash,18,26,41,15,"[comedy, drama, music]"
1115,98,"Nov 13, 2015",Love the Coopers,18,26,42,16,"[comedy, family, drama]"
1118,6,"Nov 5, 2010",127 Hours,18,18,60,42,"[adventure, drama, thriller]"
1119,9,"Jan 15, 2016",Norm of the North,18,17,30,13,"[adventure, animation, comedy, family]"
1120,11,"Aug 16, 2013",Jobs,18,16,43,27,"[drama, history]"
1121,14,"Jul 25, 2014",And So It Goes,18,15,17,2,"[comedy, drama, romance]"
1122,19,"Jan 31, 2014",Labor Day,18,13,14,1,[drama]
1123,20,"Aug 30, 2013",Getaway,18,10,11,1,"[action, crime]"
1124,31,"Aug 20, 2010",Mao's Last Dancer,18,4,25,21,"[drama, romance]"
1125,33,"Apr 11, 2014",The Railway Man,18,4,23,19,"[drama, history]"
1126,35,"Mar 18, 2016",Midnight Special,18,3,7,4,"[adventure, drama, sci-fi]"
1129,66,"Apr 6, 2018",A Quiet Place,17,188,334,146,"[drama, horror, thriller, sci-fi]"
1130,73,"Nov 15, 2013",The Best Man Holiday,17,70,72,2,[comedy]
1131,75,"Sep 28, 2012",Pitch Perfect,17,65,116,51,"[comedy, music, romance]"
1132,77,"Apr 5, 2013",Evil Dead,17,54,97,43,[horror]
1133,80,"Feb 20, 2015","McFarland, USA",17,44,45,1,[drama]
1134,87,"Mar 4, 2011",Beastly,17,27,38,11,"[drama, fantasy, romance, sci-fi]"
1137,10,"Jun 10, 2016",Genius,17,1,7,6,"[drama, history]"
1138,17,"Mar 11, 2016",The Young Messiah,16,6,7,1,[drama]
1139,22,"Aug 18, 2006",The Illusionist,16,39,83,44,"[animation, drama]"
1140,33,"May 25, 2012",Moonrise Kingdom,16,45,68,23,"[comedy, drama, romance]"
1141,34,"Nov 25, 2011",The Artist,16,44,128,84,"[drama, comedy, romance]"
1142,39,"Feb 4, 2011",The Roommate,16,37,52,15,"[thriller, drama, horror]"
1143,51,"Mar 12, 2010",Remember Me,16,19,56,37,"[drama, romance]"
1144,57,"Oct 3, 2014",Left Behind,16,14,20,6,"[thriller, action, sci-fi]"
1147,70,"Nov 14, 2014",The Homesman,16,2,8,6,"[western, drama]"
1148,71,"Apr 5, 2013",Trance,16,2,22,20,"[thriller, crime, drama, mystery]"
1149,72,"May 16, 2014",The Immigrant,16,2,7,5,"[drama, romance]"
1150,83,"Dec 21, 2018",Second Act,15,39,63,24,"[romance, comedy]"
1151,93,"Dec 5, 1984",Beverly Hills Cop,15,234,316,82,"[action, comedy, crime]"
1152,2,"Aug 11, 2017",Annabelle: Creation,15,102,305,203,"[horror, mystery, thriller]"
1153,3,"Oct 25, 2013",Jackass Presents: Bad Grandpa,15,102,160,58,[comedy]
1154,6,"Nov 28, 2014",The Imitation Game,15,91,227,136,"[history, drama, thriller, war]"
1155,9,"Jan 18, 2013",Mama,15,71,148,77,[horror]
1156,13,"Mar 19, 2010",Diary of a Wimpy Kid,15,64,76,12,"[comedy, family]"
1159,18,"Feb 3, 2012",The Woman in Black,15,54,128,74,"[drama, horror, thriller]"
1160,21,"Aug 10, 2018",BlacKkKlansman,15,49,93,44,"[crime, drama]"
1163,28,"Dec 4, 2015",Krampus,15,42,61,19,"[horror, comedy, fantasy]"
1164,29,"Sep 21, 2012",End of Watch,15,41,57,16,"[crime, drama, thriller]"
1167,35,"Nov 7, 2014",The Theory of Everything,15,35,123,88,"[drama, romance]"
1168,36,"Sep 16, 2011",Drive,15,35,81,46,"[drama, action, thriller, crime]"
1169,39,"Nov 23, 2018",The Favourite,15,34,94,60,"[drama, history, comedy]"
1170,57,"Sep 8, 2017",Home Again,15,27,37,10,"[comedy, drama, romance]"
1171,60,"Jul 23, 2010",Ramona and Beezus,15,26,27,1,"[comedy, family]"
1172,61,"Aug 27, 2014",The November Man,15,25,34,9,"[crime, action, thriller]"
1173,67,"Mar 29, 2013",The Place Beyond the Pines,15,21,47,26,"[drama, crime]"
1174,76,"Jul 25, 2014",A Most Wanted Man,15,17,36,19,[thriller]
1175,79,"Nov 2, 2012",The Man with the Iron Fists,15,15,22,7,[action]
1176,81,"Feb 1, 2019",Miss Bala,15,14,15,1,"[drama, action]"
1177,82,"Nov 30, 2012",Killing Them Softly,15,14,39,25,"[crime, thriller]"
1178,84,"Aug 19, 2011",One Day,15,13,59,46,"[drama, romance]"
1181,6,"Sep 23, 2016",Queen of Katwe,15,8,10,2,[drama]
1182,10,"May 21, 1999",The Love Letter,15,8,9,1,[]
1183,13,"Jan 4, 2013",Promised Land,15,7,12,5,[drama]
1184,15,"Jun 8, 2018",Hotel Artemis,15,6,12,6,"[thriller, sci-fi, action]"
1185,25,"Oct 30, 2015",Scouts Guide to the Zombie Apocalypse,15,3,15,12,"[comedy, horror]"
1186,27,"Sep 22, 2010",You Will Meet a Tall Dark Stranger,15,3,34,31,"[comedy, drama, romance]"
1187,29,"Sep 15, 2010",Never Let Me Go,15,2,11,9,"[drama, romance, sci-fi]"
1188,30,"Sep 9, 2016",The Disappointments Room,15,2,3,1,"[drama, horror, thriller]"
1189,66,"Jul 1, 2015",Magic Mike XXL,14,66,123,57,"[comedy, drama]"
1190,81,"Aug 31, 2012",The Possession,14,49,82,33,"[horror, thriller]"
1191,90,"Jan 13, 2012",The Iron Lady,14,29,115,86,"[history, drama]"
1192,95,"Mar 12, 2010",Our Family Wedding,14,20,21,1,[comedy]
1193,8,"Nov 17, 2006",Bobby,14,11,20,9,[documentary]
1194,10,"Oct 26, 2012",Fun Size,14,9,11,2,[comedy]
1195,16,"Oct 23, 2015",Suffragette,14,4,34,30,"[drama, history]"
1196,18,"Dec 19, 2014",Mr. Turner,14,3,25,22,"[history, drama]"
1199,36,"Oct 12, 2012",Seven Psychopaths,13,15,33,18,"[comedy, crime]"
1202,44,"Sep 12, 2014",No Good Deed,13,52,54,2,"[crime, thriller]"
1203,46,"Dec 3, 2010",Black Swan,13,106,331,225,"[drama, thriller]"
1204,48,"Feb 11, 2011",Justin Bieber: Never Say Never,13,73,99,26,"[documentary, music, family]"
1205,49,"Jul 4, 2018",The First Purge,13,69,136,67,"[action, sci-fi, thriller, horror]"
1206,50,"Mar 16, 2016",Miracles from Heaven,13,61,73,12,[drama]
1207,54,"Jun 24, 2016",The Shallows,13,55,118,63,"[horror, drama, thriller]"
1208,58,"Feb 14, 2014",About Last Night,13,48,50,2,"[comedy, romance]"
1209,61,"Oct 10, 2014",St. Vincent,13,44,54,10,[comedy]
1210,62,"Jul 2, 2014",Earth to Echo,13,38,42,4,"[family, adventure, sci-fi]"
1211,72,"Apr 10, 2015",Ex Machina,13,25,38,13,"[drama, sci-fi]"
1212,75,"Mar 11, 2016",Eye in the Sky,13,18,35,17,"[drama, thriller, war]"
1213,77,"Sep 21, 2012",The Perks of Being a Wallflower,13,17,33,16,[drama]
1216,86,"Jul 17, 2015",Bajrangi Bhaijaan,13,8,121,113,"[action, comedy, drama]"
1217,97,"Mar 26, 2010",Chloe,13,3,11,8,"[drama, thriller, mystery]"
1221,3,"Jul 24, 2015",The Vatican Tapes,13,1,14,13,"[thriller, horror]"
1222,7,"Jul 29, 2011",Attack the Block,13,1,6,5,"[action, comedy, sci-fi]"
1223,14,"Mar 15, 2013",The Call,12,51,69,18,"[crime, thriller]"
1226,16,"Sep 12, 2014",The Drop,12,10,19,9,"[drama, crime]"
1227,18,"Sep 3, 2010",Machete,12,26,46,20,"[action, comedy, thriller]"
1228,28,"Oct 15, 2010",Conviction,12,6,11,5,[drama]
1229,36,"Apr 16, 2010",The Perfect Game,12,1,3,2,"[drama, family]"
1230,41,"Jun 20, 1975",Jaws,12,260,470,210,[animation]
1231,43,"Jun 6, 2014",The Fault in Our Stars,12,124,307,183,"[romance, drama]"
1232,44,"Jul 9, 1999",American Pie,12,101,234,133,"[comedy, romance]"
1233,45,"Apr 20, 2012",Think Like a Man,12,91,113,22,"[comedy, romance]"
1234,46,"Apr 16, 2014",Heaven is for Real,12,91,100,9,[drama]
1235,52,"Feb 24, 2012",Act of Valor,12,70,82,12,"[action, thriller, war]"
1236,55,"Feb 3, 2012",Chronicle,12,64,123,59,"[sci-fi, drama, thriller]"
1243,61,"May 4, 2018",Overboard,12,50,85,35,"[romance, comedy]"
1244,65,"Nov 22, 2013",Philomena,12,37,98,61,[drama]
1245,67,"Feb 15, 2002",Crossroads,12,37,57,20,[thriller]
1246,68,"Jul 24, 2015",Paper Towns,12,32,85,53,"[drama, mystery, romance]"
1247,77,"Aug 12, 2016",Hell or High Water,12,27,37,10,"[crime, drama, thriller, western]"
1248,79,"Jul 5, 2012",Katy Perry: Part of Me,12,25,32,7,"[documentary, music]"
1249,80,"Dec 12, 2014",Top Five,12,25,26,1,"[drama, comedy]"
1250,84,"Jan 30, 2015",Project Almanac,12,22,32,10,"[sci-fi, thriller]"
1251,91,"Nov 15, 2013",Nebraska,12,17,24,7,"[drama, adventure]"
1252,94,"Dec 9, 2011",Young Adult,12,16,22,6,"[comedy, drama]"
1253,95,"Nov 1, 2013",About Time,12,15,89,74,"[comedy, drama, sci-fi]"
1254,96,"Dec 14, 2018",If Beale Street Could Talk,12,14,19,5,"[drama, romance, crime]"
1255,97,"Jul 14, 2017",Wish Upon,12,14,23,9,"[thriller, horror, fantasy]"
1258,4,"Apr 21, 2017",Unforgettable,12,11,16,5,"[drama, thriller]"
1259,9,"Sep 14, 2012",Arbitrage,12,7,35,28,"[drama, thriller]"
1260,13,"Sep 3, 1993",Fortress,12,6,46,40,"[action, war]"
1261,14,"Jun 1, 2012",For Greater Glory: The True Story of Cristiada,12,5,10,5,"[history, drama]"
1262,29,"Mar 1, 2013",Stoker,12,1,12,11,"[drama, horror, thriller]"
1265,62,"Jan 22, 2016",Dirty Grandpa,11,35,105,70,[comedy]
1266,68,"Dec 10, 2010",The Fighter,11,93,129,36,[drama]
1267,73,"Aug 22, 2014",If I Stay,11,50,78,28,[drama]
1270,81,"Apr 1, 2015",Woman in Gold,11,33,58,25,[drama]
1273,90,"Jan 11, 2013",Quartet,11,18,56,38,"[drama, comedy, romance]"
1274,94,"Dec 6, 2013",Inside Llewyn Davis,11,13,32,19,[drama]
1275,27,"Apr 2, 1968",2001: A Space Odyssey,10,59,71,12,"[sci-fi, mystery, adventure]"
1276,37,"Dec 5, 1997",Good Will Hunting,10,138,225,87,[drama]
1277,42,"Jul 1, 2016",The Purge: Election Year,10,79,118,39,"[action, horror, thriller]"
1280,45,"Jan 5, 2018",Insidious: The Last Key,10,67,167,100,"[mystery, horror, thriller]"
1283,55,"May 4, 2012",The Best Exotic Marigold Hotel,10,46,134,88,"[drama, comedy]"
1284,56,"Jun 8, 2018",Hereditary,10,44,70,26,"[horror, mystery, thriller]"
1285,57,"Mar 16, 2018","Love, Simon",10,40,65,25,"[comedy, drama, romance]"
1286,61,"Oct 27, 2017",Jigsaw,10,38,102,64,"[crime, horror, mystery, thriller]"
1289,70,"May 19, 2017","Everything, Everything",10,34,61,27,"[drama, romance]"
1290,71,"Sep 17, 2010",Devil,10,33,63,30,"[horror, mystery, thriller]"
1291,73,"Mar 6, 2015",The Second Best Exotic Marigold Hotel,10,33,90,57,"[drama, comedy]"
1292,75,"Apr 28, 2017",How to Be a Latin Lover,10,32,62,30,[comedy]
1293,80,"Aug 10, 2018",Slender Man,10,30,51,21,"[mystery, thriller, horror]"
1294,85,"Sep 9, 2016",When the Bough Breaks,10,29,30,1,"[mystery, drama, horror]"
1295,91,"Aug 21, 2015",Sinister 2,10,27,54,27,[horror]
1299,98,"Apr 26, 2013",Mud,10,21,31,10,[drama]
1300,99,"Nov 12, 2010",Skyline,10,21,68,47,"[sci-fi, action]"
1305,7,"Oct 23, 2015",Paranormal Activity: The Ghost Dimension,10,18,77,59,"[horror, thriller]"
1306,14,"Jun 17, 2005",The Perfect Man,10,16,19,3,"[drama, comedy, romance, family]"
1309,22,"Nov 23, 2011",My Week with Marilyn,10,14,34,20,[drama]
1310,23,"Dec 25, 2014",Big Eyes,10,14,27,13,[drama]
1321,39,"Jan 25, 2013",Movie 43,10,8,31,23,[comedy]
1322,40,"Oct 19, 2018",Can You Ever Forgive Me?,10,8,11,3,"[drama, crime]"
1325,47,"Oct 24, 2001",Bones,10,7,8,1,[drama]
1326,48,"Jun 22, 2012",Seeking a Friend for the End of the World,10,7,11,4,"[comedy, drama, romance, sci-fi]"
1327,50,"Nov 11, 2016",Shut In,10,6,11,5,"[drama, thriller]"
1328,51,"Feb 11, 2011",Cedar Rapids,10,6,7,1,[comedy]
1331,59,"Mar 20, 2015",Danny Collins,10,5,8,3,"[comedy, drama, music]"
1332,64,"Jun 15, 2018",Gotti,10,4,6,2,"[crime, drama, history, thriller]"
1335,67,"Apr 29, 2016",The Man Who Knew Infinity,10,3,12,9,[drama]
1338,81,"May 3, 2013",The Iceman,10,1,3,2,"[thriller, crime, drama]"
1339,82,"Jun 5, 2015",Testament of Youth,10,1,6,5,"[history, drama, war]"
1340,83,"Apr 21, 2017",Free Fire,10,1,3,2,"[action, crime, mystery]"
1343,90,"Jul 27, 2012",Killer Joe,10,1,4,3,"[crime, drama, thriller]"
1344,91,"Jun 2, 2017",Churchill,10,1,7,6,"[drama, thriller, war]"
1347,51,"Dec 19, 2012",Amour,9,6,36,30,"[drama, romance]"
1348,56,"Dec 21, 2016",Dangal,9,12,294,282,"[drama, action]"
1349,57,"Mar 19, 2010",The Runaways,9,3,5,2,"[drama, music]"
1350,62,"Nov 11, 2011",Melancholia,9,3,21,18,"[drama, sci-fi]"
1351,64,"Nov 13, 2012",Jab Tak Hai Jaan,9,3,5,2,"[drama, romance]"
1352,66,"May 21, 2010",Kites,9,1,17,16,"[drama, action, romance]"
1353,71,"Jul 18, 2014",The Purge: Anarchy,9,71,111,40,"[horror, thriller]"
1358,87,"Dec 2, 2016",Jackie,9,13,36,23,[drama]
1361,3,"Mar 22, 2013",The Sapphires,9,2,20,18,"[comedy, drama]"
1362,5,"Dec 25, 2018",Destroyer,9,1,3,2,"[thriller, crime, drama, action]"
1363,27,"Sep 26, 1986",Crocodile Dundee,8,174,328,154,"[adventure, comedy]"
1366,33,"Feb 20, 2015",The DUFF,8,34,43,9,"[romance, comedy]"
1367,34,"Oct 31, 2014",Nightcrawler,8,32,50,18,"[crime, drama, thriller]"
1368,36,"Jan 16, 2019",Dragon Ball Super: Broly,8,30,122,92,"[action, animation, fantasy, adventure, comedy, sci-fi]"
1369,38,"Sep 27, 2013",Baggage Claim,8,21,22,1,[comedy]
1370,39,"Oct 7, 2016",Middle School: The Worst Years of My Life,8,20,23,3,"[family, comedy]"
1371,47,"Jun 13, 2014",The Rover,8,1,3,2,"[crime, drama]"
1372,67,"Sep 17, 2010",Easy A,8,58,76,18,[comedy]
1373,73,"Sep 30, 2011",50/50,8,35,41,6,"[comedy, drama]"
1374,75,"Sep 2, 2015",A Walk in the Woods,8,29,37,8,"[adventure, comedy, drama]"
1375,78,"Jan 31, 2014",That Awkward Moment,8,26,53,27,"[comedy, romance]"
1376,79,"Mar 21, 2008",Shutter,8,25,47,22,"[thriller, horror, sci-fi]"
1377,88,"Sep 18, 2013",Enough Said,8,17,25,8,"[comedy, drama, romance]"
1378,91,"Jun 27, 2014",Begin Again,8,16,68,52,"[comedy, music, romance, drama]"
1379,100,"Jun 12, 2015",Me and Earl and the Dying Girl,8,6,9,3,"[comedy, drama]"
1388,14,"Nov 19, 2010",Made in Dagenham,8,1,15,14,"[comedy, drama, history]"
1389,67,"Dec 21, 2011",Albert Nobbs,7,3,8,5,[drama]
1390,68,"Jun 24, 2016",The Neon Demon,7,1,3,2,"[thriller, horror, mystery]"
1391,77,"Jan 13, 2017",The Bye Bye Man,7,22,31,9,"[horror, thriller]"
1392,81,"Apr 30, 2010",Harry Brown,7,1,12,11,"[thriller, crime, drama, action]"
1393,88,"Jun 29, 2012",Magic Mike,7,113,170,57,"[drama, comedy]"
1394,90,"Mar 16, 2018",I Can Only Imagine,7,83,85,2,"[drama, family, music]"
1395,93,"May 6, 2011",Jumping the Broom,7,37,38,1,[comedy]
1396,4,"Apr 7, 2017",Gifted,7,24,36,12,"[drama, family, comedy]"
1397,11,"Jun 19, 2015",Dope,7,17,18,1,"[crime, drama, comedy]"
1398,14,"Jan 17, 2014",Devil's Due,7,15,36,21,[horror]
1399,23,"Jul 30, 2010",Get Low,7,9,10,1,"[comedy, drama, mystery]"
1400,27,"Jun 18, 2010",Cyrus,7,7,10,3,"[comedy, drama, romance]"
1401,42,"Dec 22, 2010",Somewhere,7,1,17,16,"[comedy, drama]"
1404,73,"Sep 21, 2012",House at the End of the Street,6,31,44,13,"[horror, thriller]"
1405,76,"Sep 17, 2010",Incendies,6,6,16,10,"[drama, war, mystery]"
1406,84,"Oct 3, 2014",Annabelle,6,84,256,172,[horror]
1410,99,"May 31, 2013",The East,6,2,3,1,"[drama, thriller]"
1413,37,"Nov 30, 2018",The Possession of Hannah Grace,6,14,42,28,"[horror, drama]"
1414,46,"Sep 7, 2012",The Words,6,11,16,5,"[drama, thriller]"
1419,54,"Jul 29, 2011",The Guard,6,5,21,16,"[action, comedy, thriller, crime]"
1420,61,"Jul 18, 2014",Wish I Was Here,6,3,6,3,"[drama, comedy]"
1421,70,"Jul 15, 2011",Snow Flower and the Secret Fan,6,1,11,10,"[drama, history]"
1425,18,"Sep 27, 2013",Don Jon,5,24,41,17,"[romance, comedy, drama]"
1426,20,"Sep 28, 2018",Hell Fest,5,11,18,7,[horror]
1433,51,"Oct 21, 2011",Paranormal Activity 3,5,104,207,103,[horror]
1434,54,"Mar 11, 2016",10 Cloverfield Lane,5,72,108,36,"[thriller, sci-fi, drama]"
1435,55,"Jul 22, 2016",Lights Out,5,67,148,81,"[thriller, mystery, horror]"
1438,58,"Oct 13, 2017",Happy Death Day,5,55,125,70,"[horror, mystery, thriller]"
1439,59,"Oct 19, 2012",Paranormal Activity 4,5,53,142,89,[horror]
1440,60,"Oct 24, 2014",Ouija,5,50,103,53,[horror]
1441,64,"Jun 23, 2017",The Big Sick,5,42,53,11,"[comedy, drama, romance]"
1444,70,"Jan 3, 2014",Paranormal Activity: The Marked Ones,5,32,90,58,"[horror, thriller]"
1445,72,"Apr 11, 2014",Oculus,5,27,44,17,[horror]
1448,74,"Aug 26, 2015",No Escape,5,27,42,15,"[action, thriller]"
1451,78,"Aug 26, 2011",Our Idiot Brother,5,24,25,1,"[comedy, drama]"
1452,79,"Mar 9, 2018",The Strangers: Prey at Night,5,24,29,5,"[horror, thriller]"
1453,83,"Jul 5, 2013",The Way Way Back,5,21,26,5,"[comedy, drama]"
1454,84,"Aug 29, 2014","As Above, So Below",5,21,41,20,"[horror, thriller]"
1455,90,"Feb 19, 2016",Race,5,19,23,4,"[action, drama]"
1456,92,"Jan 16, 2015",Still Alice,5,18,41,23,[drama]
1457,94,"Sep 2, 2011",Apollo 18,5,17,26,9,"[horror, thriller, sci-fi]"
1458,95,"Mar 23, 2018","Paul, Apostle of Christ",5,17,25,8,[history]
1459,3,"Mar 15, 2013",Spring Breakers,5,14,31,17,"[drama, crime]"
1460,4,"Jun 9, 2017",It Comes at Night,5,13,19,6,[horror]
1461,12,"Mar 3, 2017",Before I Fall,5,12,18,6,"[drama, mystery, thriller, fantasy]"
1462,15,"Jan 29, 2016",Fifty Shades of Black,5,11,22,11,"[romance, comedy]"
1463,21,"Mar 17, 2017",The Belko Experiment,5,10,11,1,"[action, thriller]"
1464,22,"Mar 11, 2016",The Perfect Match,5,9,10,1,"[comedy, romance]"
1465,31,"May 28, 2010",Sea Rex 3D: Journey to a Prehistoric World,5,6,16,10,[documentary]
1466,39,"Dec 2, 2016",Incarnate,5,4,9,5,"[horror, thriller]"
1467,45,"Mar 3, 2017",Table 19,5,3,4,1,"[comedy, drama]"
1468,49,"Mar 4, 2016",The Other Side of the Door,5,3,12,9,"[thriller, horror]"
1469,51,"Oct 10, 2014",Kill the Messenger,5,2,6,4,"[thriller, crime, drama, mystery]"
1470,52,"Dec 17, 2010",Rabbit Hole,5,2,6,4,[drama]
1473,1,"Jan 23, 2015",Mommy,4,3,17,14,[drama]
1474,9,"Sep 30, 2011",Take Shelter,4,1,4,3,"[thriller, drama]"
1477,33,"Oct 4, 1996",Bound,4,3,7,4,"[thriller, drama]"
1478,71,"Aug 13, 2010",Animal Kingdom,4,1,8,7,"[drama, thriller, crime, mystery]"
1481,85,"Jul 11, 2014",Boyhood,4,25,57,32,[drama]
1482,87,"Jul 9, 2010",The Kids Are All Right,4,20,36,16,"[comedy, drama]"
1483,89,"Apr 18, 2014",A Haunted House 2,4,17,21,4,"[comedy, horror]"
1484,90,"Mar 1, 2013",The Last Exorcism Part II,4,15,25,10,"[horror, thriller, drama]"
1485,18,"Aug 24, 2012",Samsara,4,2,5,3,"[drama, documentary]"
1493,95,"Feb 2, 2018",Winchester,3,25,44,19,"[fantasy, mystery, thriller, horror]"
1494,96,"Dec 6, 2002",Empire,3,17,18,1,[]
1495,97,"Feb 22, 2013",Dark Skies,3,17,27,10,"[sci-fi, thriller, horror]"
1496,37,"Oct 21, 2011",Margin Call,3,5,20,15,"[thriller, drama]"
1499,54,"Jul 6, 2018",Sorry to Bother You,3,17,18,1,"[fantasy, sci-fi, comedy]"
1500,57,"Jun 3, 2011",Beginners,3,5,14,9,"[drama, romance, comedy]"
1501,58,"Apr 22, 2016",The Meddler,3,4,5,1,"[comedy, drama]"
1502,65,"Oct 20, 2010",Paranormal Activity 2,3,84,177,93,"[horror, thriller]"
1503,66,"Aug 28, 2015",War Room,3,67,73,6,"[drama, romance]"
1504,67,"Jun 7, 2013",The Purge,3,64,91,27,"[sci-fi, horror, thriller]"
1507,89,"Jun 1, 2018",Upgrade,3,11,16,5,"[action, thriller, sci-fi]"
1508,99,"May 24, 2013",Before Midnight,3,8,23,15,"[romance, drama]"
1509,1,"Jul 31, 2009",The Collector,3,7,10,3,"[drama, romance]"
1510,10,"Jun 24, 2016",Swiss Army Man,3,4,5,1,"[comedy, drama, romance, fantasy, adventure]"
1513,21,"Apr 22, 2016",Compadres,3,3,7,4,"[action, comedy]"
1514,25,"Apr 9, 2010",Letters to God,3,2,3,1,"[drama, family]"
1515,26,"Oct 16, 1998",Happiness,3,2,5,3,[documentary]
1518,3,"May 2, 2014",Ida,2,3,15,12,[drama]
1519,12,"Jan 11, 2013",A Haunted House,2,40,59,19,"[comedy, horror]"
1520,25,"Jun 24, 2016",Hunt for the Wilderpeople,2,5,23,18,"[adventure, comedy, drama]"
1521,26,"Aug 17, 2012",Robot & Frank,2,3,4,1,"[sci-fi, comedy, drama, crime]"
1522,60,"Mar 20, 2015",Do You Believe?,2,12,14,2,"[fantasy, drama]"
1523,87,"Sep 30, 2011",Courageous,2,34,35,1,[drama]
1526,95,"Jul 13, 2018",Eighth Grade,2,13,14,1,"[comedy, drama]"
1527,97,"Mar 9, 2012",Silent House,2,12,16,4,"[horror, mystery]"
1528,100,"Apr 8, 2016",Hardcore Henry,2,9,17,8,"[action, adventure, sci-fi]"
1529,8,"Jun 11, 2010",Winter's Bone,2,6,16,10,[drama]
1530,11,"Oct 6, 2017",The Florida Project,2,5,11,6,[drama]
1531,17,"Oct 8, 2010",Inside Job,2,4,7,3,[documentary]
1532,20,"Aug 28, 2015",We Are Your Friends,2,3,10,7,"[drama, music, romance, comedy]"
1533,35,"Aug 7, 2015",The Diary of a Teenage Girl,2,1,2,1,"[drama, romance]"
1534,37,"Apr 25, 2014",Locke,2,1,2,1,"[drama, thriller]"
1535,2,"Sep 24, 2010",Buried,1,1,21,20,"[drama, thriller, mystery]"
1536,6,"Oct 8, 2010",Nowhere Boy,1,1,7,6,[drama]
1537,15,"Aug 27, 2010",The Last Exorcism,1,41,70,29,"[horror, drama, thriller]"
1538,18,"Jun 27, 2012",Beasts of the Southern Wild,1,12,23,11,"[drama, fantasy, adventure]"
1539,42,"Feb 28, 2014",The Lunchbox,1,4,12,8,"[drama, romance]"
1540,63,"Apr 1, 2011",Insidious,1,54,99,45,"[horror, thriller]"
1543,65,"Sep 12, 2003",Cabin Fever,1,21,30,9,[horror]
1544,70,"Mar 23, 2018",Unsane,1,7,14,7,"[horror, thriller]"
1547,77,"Jul 26, 2013",The To Do List,1,3,4,1,"[comedy, romance]"
1548,82,"Jan 18, 1985",Blood Simple,1,1,2,1,"[crime, drama, thriller]"
1549,51,"Oct 17, 2014",Dear White People,1,4,5,1,"[comedy, drama]"
1550,57,"Oct 29, 2004",Saw,1,55,103,48,"[horror, mystery, crime]"
1551,12,"Jan 6, 2012",The Devil Inside,1,53,101,48,"[thriller, horror]"
1552,14,"Apr 17, 2015",Unfriended,1,32,64,32,"[horror, thriller]"
1553,17,"Aug 23, 2013",You're Next,1,18,26,8,"[horror, thriller, mystery]"
1554,18,"May 25, 2012",Chernobyl Diaries,1,18,42,24,"[horror, thriller]"
1557,29,"Jul 20, 2018",Unfriended: Dark Web,1,8,16,8,[horror]
1558,31,"Sep 25, 2015",The Green Inferno,1,7,12,5,"[action, adventure, horror, thriller]"
1559,32,"Feb 3, 2017",I Am Not Your Negro,1,7,9,2,[documentary]
1560,33,"Oct 19, 2012",The Sessions,1,6,11,5,"[drama, romance, comedy]"
1561,42,"Oct 21, 2011",Martha Marcy May Marlene,1,2,5,3,"[drama, thriller]"
