,id,release_date,movie,production_budget,domestic_gross,worldwide_gross,international_gross,genre_ids
0,1,18-Dec-09,Avatar,425,760,2776,2016,"[action, adventure, fantasy, sci-fi]"
1,2,20-May-11,Pirates of the Caribbean: On Stranger Tides,410,241,1045,804,"[adventure, action, fantasy]"
2,4,1-May-15,Avengers: Age of Ultron,330,459,1403,944,"[action, adventure, sci-fi]"
3,7,27-Apr-18,Avengers: Infinity War,300,678,2048,1370,"[adventure, action, fantasy]"
4,9,17-Nov-17,Justice League,300,229,655,426,"[action, adventure, fantasy, sci-fi]"
5,9,17-Nov-17,Justice League,300,229,655,426,"[action, adventure, fantasy, sci-fi]"
6,10,6-Nov-15,Spectre,300,200,879,679,"[action, adventure, crime]"
7,10,6-Nov-15,Spectre,300,200,879,679,"[action, adventure, crime]"
8,11,20-Jul-12,The Dark Knight Rises,275,448,1084,636,"[action, crime, drama, thriller]"
9,12,25-May-18,Solo: A Star Wars Story,275,213,393,180,"[action, adventure, sci-fi]"
10,13,2-Jul-13,The Lone Ranger,275,89,260,171,"[action, adventure, western]"
11,14,9-Mar-12,John Carter,275,73,282,209,"[action, adventure, sci-fi]"
12,15,24-Nov-10,Tangled,260,200,586,386,"[animation, family]"
13,17,6-May-16,Captain America: Civil War,250,408,1140,732,"[adventure, action, sci-fi]"
14,18,25-Mar-16,Batman v Superman: Dawn of Justice,250,330,867,537,"[action, adventure, fantasy]"
15,19,14-Dec-12,The Hobbit: An Unexpected Journey,250,303,1017,714,"[adventure, fantasy, action]"
16,21,13-Dec-13,The Hobbit: The Desolation of Smaug,250,258,960,702,"[adventure, fantasy, action]"
17,22,17-Dec-14,The Hobbit: The Battle of the Five Armies,250,255,945,690,"[action, adventure, fantasy]"
18,23,14-Apr-17,The Fate of the Furious,250,225,1234,1009,"[action, crime, thriller]"
19,25,26-May-17,Pirates of the Caribbean: Dead Men Tell No Tales,230,172,788,616,"[adventure, action, fantasy, comedy]"
20,27,4-May-12,The Avengers,225,623,1517,894,"[sci-fi, action, adventure]"
21,35,14-Aug-98,The Avengers,60,23,48,25,"[sci-fi, action, adventure]"
22,29,14-Jun-13,Man of Steel,225,291,667,376,"[action, adventure, fantasy, sci-fi]"
23,31,3-Jul-12,The Amazing Spider-Man,220,262,757,495,"[action, adventure, fantasy]"
24,32,18-May-12,Battleship,220,65,313,248,"[thriller, action, adventure, sci-fi]"
25,33,21-Jun-17,Transformers: The Last Knight,217,130,602,472,"[action, sci-fi, thriller, adventure]"
26,34,12-Jun-15,Jurassic World,215,652,1648,996,"[action, adventure, sci-fi, thriller]"
27,35,25-May-12,Men in Black 3,215,179,654,475,"[action, comedy, sci-fi]"
28,37,27-Jun-14,Transformers: Age of Extinction,210,245,1104,859,"[sci-fi, action, adventure]"
29,39,14-May-10,Robin Hood,210,105,322,217,"[action, adventure, drama]"
30,39,14-May-10,Robin Hood,210,105,322,217,"[adventure, animation, family]"
31,39,14-May-10,Robin Hood,210,105,322,217,"[adventure, action, thriller]"
32,9,21-Nov-18,Robin Hood,99,30,84,54,"[action, adventure, drama]"
33,9,21-Nov-18,Robin Hood,99,30,84,54,"[adventure, animation, family]"
34,9,21-Nov-18,Robin Hood,99,30,84,54,"[adventure, action, thriller]"
35,42,16-Feb-18,Black Panther,200,700,1348,648,"[action, animation]"
36,42,16-Feb-18,Black Panther,200,700,1348,648,"[action, adventure, fantasy, sci-fi]"
37,44,15-Jun-18,Incredibles 2,200,608,1242,634,"[action, adventure, animation, family]"
38,45,16-Dec-16,Rogue One: A Star Wars Story,200,532,1049,517,"[action, adventure, sci-fi]"
39,45,16-Dec-16,Rogue One: A Star Wars Story,200,532,1049,517,"[action, adventure, sci-fi]"
40,46,17-Jun-16,Finding Dory,200,486,1021,535,"[adventure, animation, comedy, family]"
41,47,18-Jun-10,Toy Story 3,200,415,1068,653,"[animation, family, comedy]"
42,48,3-May-13,Iron Man 3,200,408,1215,807,"[action, adventure, sci-fi]"
43,51,5-Mar-10,Alice in Wonderland,200,334,1025,691,"[family, fantasy, adventure]"
44,51,5-Mar-10,Alice in Wonderland,200,334,1025,691,[]
45,52,8-Nov-12,Skyfall,200,304,1110,806,"[action, adventure, thriller]"
46,53,21-Jun-13,Monsters University,200,268,743,475,"[animation, family]"
47,54,8-Mar-13,Oz the Great and Powerful,200,234,490,256,"[fantasy, adventure, family]"
48,55,23-May-14,X-Men: Days of Future Past,200,233,747,514,"[action, adventure, fantasy, sci-fi]"
49,56,2-May-14,The Amazing Spider-Man 2,200,202,708,506,"[action, adventure, fantasy]"
50,57,24-Jun-11,Cars 2,200,191,560,369,"[animation, family, adventure, comedy]"
51,59,13-Nov-09,2012,200,166,757,591,[documentary]
52,60,16-Nov-18,Fantastic Beasts: The Crimes of Grindelwald,200,159,652,493,[adventure]
53,62,17-Jun-11,Green Lantern,200,116,219,103,"[adventure, action, thriller, sci-fi]"
54,64,29-Jun-11,Transformers: Dark of the Moon,195,352,1123,771,"[action, sci-fi, adventure]"
55,65,9-Jun-17,The Mummy,195,80,409,329,"[fantasy, thriller, action, adventure, horror]"
56,44,7-May-99,The Mummy,80,155,416,261,"[fantasy, thriller, action, adventure, horror]"
57,66,1-Mar-13,Jack the Giant Slayer,195,65,197,132,"[action, adventure, family, fantasy]"
58,67,3-Apr-15,Furious 7,190,353,1518,1165,"[action, crime, thriller]"
59,68,16-May-13,Star Trek Into Darkness,190,228,467,239,"[action, adventure, sci-fi]"
60,69,21-Jun-13,World War Z,190,202,531,329,"[action, drama, horror, sci-fi, thriller]"
61,70,10-May-13,The Great Gatsby,190,144,351,207,"[drama, romance]"
62,72,12-Jul-13,Pacific Rim,190,101,411,310,"[action, sci-fi, adventure]"
63,73,25-Nov-15,The Good Dinosaur,187,123,333,210,"[adventure, animation, family]"
64,73,25-Nov-15,The Good Dinosaur,187,123,333,210,"[adventure, animation, family]"
65,75,18-Jul-08,The Dark Knight,185,533,1001,468,"[action, crime, drama, thriller]"
66,77,22-Jun-12,Brave,185,237,554,317,[action]
67,77,22-Jun-12,Brave,185,237,554,317,"[animation, adventure, comedy, family, action, fantasy]"
68,78,10-Mar-17,Kong: Skull Island,185,168,561,393,"[action, adventure, fantasy]"
69,79,22-Jul-16,Star Trek Beyond,185,158,335,177,"[action, adventure, sci-fi]"
70,80,6-Oct-17,Blade Runner 2049,185,92,259,167,"[sci-fi, action, thriller]"
71,80,6-Oct-17,Blade Runner 2049,185,92,259,167,"[sci-fi, action, thriller]"
72,82,3-Nov-17,Thor: Ragnarok,180,315,846,531,"[action, adventure, comedy, fantasy]"
73,82,3-Nov-17,Thor: Ragnarok,180,315,846,531,"[action, adventure, comedy, fantasy]"
74,84,30-May-14,Maleficent,180,241,758,517,"[fantasy, adventure, action, family, romance]"
75,85,18-Nov-16,Fantastic Beasts and Where to Find Them,180,234,802,568,"[adventure, family, fantasy]"
76,85,18-Nov-16,Fantastic Beasts and Where to Find Them,180,234,802,568,"[adventure, family, fantasy]"
77,88,1-Jul-16,The Legend of Tarzan,180,126,348,222,"[action, adventure]"
78,89,23-Nov-11,Hugo,180,73,180,107,"[adventure, drama, family]"
79,90,21-Jul-17,Valerian and the City of a Thousand Planets,180,40,215,175,"[adventure, sci-fi, action]"
80,91,6-Feb-15,Jupiter Ascending,179,47,181,134,"[sci-fi, fantasy, action, adventure]"
81,93,27-May-16,X-Men: Apocalypse,178,155,542,387,"[action, adventure, sci-fi, fantasy]"
82,94,10-Aug-18,The Meg,178,145,529,384,"[action, sci-fi, thriller, horror]"
83,95,6-Jun-14,Edge of Tomorrow,178,100,370,270,"[action, sci-fi]"
84,97,15-Apr-16,The Jungle Book,175,364,962,598,"[adventure, drama, family, fantasy]"
85,98,19-Jun-15,Inside Out,175,356,854,498,"[drama, crime]"
86,98,19-Jun-15,Inside Out,175,356,854,498,"[drama, comedy, animation, family]"
87,99,7-Jul-17,Spider-Man: Homecoming,175,334,880,546,"[action, adventure, sci-fi, drama]"
88,100,5-Aug-16,Suicide Squad,175,325,746,421,"[action, adventure, crime, fantasy, sci-fi]"
89,2,22-Nov-17,Coco,175,209,798,589,"[animation, family, comedy, adventure, fantasy]"
90,2,22-Nov-17,Coco,175,209,798,589,"[animation, family, comedy, adventure, fantasy]"
91,5,16-Jun-17,Cars 3,175,152,383,231,"[adventure, animation, comedy, family]"
92,11,12-May-17,King Arthur: Legend of the Sword,175,39,139,100,"[action, drama, fantasy]"
93,12,25-Dec-13,47 Ronin,175,38,151,113,"[drama, action, adventure, fantasy]"
94,13,22-Jun-18,Jurassic World: Fallen Kingdom,170,417,1305,888,"[action, adventure, sci-fi]"
95,14,1-Aug-14,Guardians of the Galaxy,170,333,770,437,"[action, sci-fi, adventure]"
96,15,7-May-10,Iron Man 2,170,312,621,309,"[adventure, action, sci-fi]"
97,16,4-Apr-14,Captain America: The Winter Soldier,170,259,714,455,"[action, adventure, sci-fi]"
98,17,11-Jul-14,Dawn of the Planet of the Apes,170,208,710,502,"[sci-fi, action, drama, thriller]"
99,19,1-Jun-12,Snow White and the Huntsman,170,155,401,246,"[adventure, fantasy, drama]"
100,21,7-May-04,Van Helsing,170,120,300,180,"[horror, adventure, action]"
101,23,22-May-15,Tomorrowland,170,93,206,113,"[adventure, family, mystery, sci-fi]"
102,26,27-May-16,Alice Through the Looking Glass,170,77,276,199,"[adventure, family, fantasy]"
103,27,21-May-10,Shrek Forever After,165,238,756,518,"[comedy, adventure, fantasy, animation, family]"
104,28,4-Nov-16,Doctor Strange,165,232,676,444,"[action, adventure, fantasy, sci-fi]"
105,28,4-Nov-16,Doctor Strange,165,232,676,444,"[action, adventure, fantasy, sci-fi]"
106,29,7-Nov-14,Big Hero 6,165,222,652,430,"[adventure, family, animation, action, comedy]"
107,29,7-Nov-14,Big Hero 6,165,222,652,430,"[adventure, family, animation, action, comedy]"
108,30,26-Mar-10,How to Train Your Dragon,165,217,494,277,"[fantasy, adventure, animation, family]"
109,31,2-Nov-12,Wreck-It Ralph,165,189,496,307,"[family, animation, comedy, adventure]"
110,32,5-Nov-14,Interstellar,165,188,666,478,"[adventure, drama, sci-fi]"
111,33,24-Jun-16,Independence Day: Resurgence,165,103,384,281,"[action, adventure, sci-fi]"
112,35,17-Mar-17,Beauty and the Beast,160,504,1259,755,"[romance, family, animation, fantasy]"
113,35,17-Mar-17,Beauty and the Beast,160,504,1259,755,"[fantasy, romance]"
114,35,17-Mar-17,Beauty and the Beast,160,504,1259,755,"[family, fantasy, romance]"
115,86,13-Nov-91,Beauty and the Beast,20,376,608,232,"[romance, family, animation, fantasy]"
116,86,13-Nov-91,Beauty and the Beast,20,376,608,232,"[fantasy, romance]"
117,86,13-Nov-91,Beauty and the Beast,20,376,608,232,"[family, fantasy, romance]"
118,36,21-Dec-18,Aquaman,160,335,1146,811,"[action, adventure, fantasy]"
119,38,16-Jul-10,Inception,160,292,835,543,"[action, sci-fi, adventure]"
120,39,20-Nov-15,The Hunger Games: Mockingjay - Part 2,160,281,648,367,"[action, adventure, sci-fi]"
121,39,20-Nov-15,The Hunger Games: Mockingjay - Part 2,160,281,648,367,"[action, adventure, sci-fi]"
122,41,16-May-14,Godzilla,160,200,529,329,"[action, drama, sci-fi]"
123,74,19-May-98,Godzilla,125,136,376,240,"[action, drama, sci-fi]"
124,42,3-Jun-11,X-Men: First Class,160,146,355,209,"[action, sci-fi, adventure]"
125,44,14-Jul-10,The Sorcerer's Apprentice,160,63,217,154,"[fantasy, adventure, action, comedy, drama]"
126,46,10-Jun-16,Warcraft,160,47,425,378,"[action, adventure, fantasy]"
127,47,30-Sep-16,Deepwater Horizon,156,61,122,61,"[drama, action]"
128,47,30-Sep-16,Deepwater Horizon,156,61,122,61,"[drama, action]"
129,48,10-Dec-10,The Chronicles of Narnia: The Voyage of the Dawn Treader,155,104,418,314,"[adventure, family, fantasy]"
130,50,23-Mar-18,Pacific Rim: Uprising,155,59,290,231,"[action, fantasy, sci-fi, adventure]"
131,52,14-Jul-17,War for the Planet of the Apes,152,146,489,343,"[drama, sci-fi, war]"
132,55,2-Jun-17,Wonder Woman,150,412,821,409,"[action, fantasy]"
133,55,2-Jun-17,Wonder Woman,150,412,821,409,"[adventure, fantasy, war, romance]"
134,56,22-Nov-13,Frozen,150,400,1272,872,[thriller]
135,56,22-Nov-13,Frozen,150,400,1272,872,"[animation, adventure, family]"
136,57,4-Mar-16,Zootopia,150,341,1019,678,"[animation, adventure, family, comedy]"
137,62,23-Nov-16,Moana,150,248,637,389,[documentary]
138,62,23-Nov-16,Moana,150,248,637,389,"[adventure, comedy, family, animation]"
139,62,23-Nov-16,Moana,150,248,637,389,"[adventure, comedy, family, animation]"
140,66,8-Nov-13,Thor: The Dark World,150,206,644,438,"[action, adventure, fantasy]"
141,69,21-Jul-17,Dunkirk,150,190,499,309,"[war, action, drama]"
142,70,6-May-11,Thor,150,181,449,268,"[adventure, fantasy, action]"
143,74,26-May-11,Kung Fu Panda 2,150,165,664,499,"[animation, family]"
144,75,15-May-15,Mad Max: Fury Road,150,153,370,217,"[action, adventure, sci-fi]"
145,78,29-Mar-18,Ready Player One,150,137,579,442,"[adventure, sci-fi]"
146,83,1-Jul-10,The Last Airbender,150,131,319,188,"[action, adventure, family, fantasy]"
147,87,30-Mar-12,Wrath of the Titans,150,83,305,222,"[fantasy, adventure, action]"
148,89,11-May-12,Dark Shadows,150,79,238,159,"[comedy, fantasy]"
149,90,28-Jun-13,White House Down,150,73,205,132,"[action, drama, thriller]"
150,91,12-Feb-10,The Wolfman,150,62,142,80,[horror]
151,92,17-Feb-17,The Great Wall,150,45,334,289,"[action, adventure, fantasy]"
152,93,9-Oct-15,Pan,150,35,151,116,"[adventure, family, fantasy]"
153,94,11-Mar-11,Mars Needs Moms,150,21,39,18,"[adventure, animation, family]"
154,97,8-Jun-12,Madagascar 3: Europe's Most Wanted,145,216,746,530,"[animation, family, comedy]"
155,99,13-Jun-14,How to Train Your Dragon 2,145,177,614,437,"[fantasy, action, adventure, animation, comedy, family]"
156,100,16-Jun-99,Tarzan,145,171,448,277,"[animation, action, adventure, family]"
157,1,7-Mar-14,Mr. Peabody & Sherman,145,111,269,158,"[animation, adventure, family]"
158,2,21-Nov-12,Rise of the Guardians,145,103,306,203,"[animation, family, fantasy]"
159,4,15-Jul-16,Ghostbusters,144,128,229,101,"[action, fantasy, comedy]"
160,36,8-Jun-84,Ghostbusters,30,242,295,53,"[action, fantasy, comedy]"
161,8,1-Jul-98,Armageddon,140,201,554,353,"[action, thriller, sci-fi, adventure]"
162,10,22-Jul-11,Captain America: The First Avenger,140,176,370,194,"[action, adventure, sci-fi]"
163,11,29-Jan-16,Kung Fu Panda 3,140,143,517,374,"[action, adventure, animation, comedy, family]"
164,13,27-Mar-13,G.I. Joe: Retaliation,140,122,375,253,"[adventure, action, sci-fi, thriller]"
165,16,12-Dec-14,Exodus: Gods and Kings,140,65,268,203,"[adventure, drama, action]"
166,17,1-Jul-16,The BFG,140,55,199,144,"[adventure, family, fantasy]"
167,18,26-Feb-16,Gods of Egypt,140,31,138,107,"[action, adventure, fantasy, sci-fi]"
168,26,22-Mar-13,The Croods,135,187,573,386,"[action, adventure, animation, comedy, family, fantasy]"
169,27,25-Dec-15,The Revenant,135,183,532,349,"[western, drama, adventure]"
170,27,25-Dec-15,The Revenant,135,183,532,349,"[western, drama, adventure]"
171,29,4-Mar-11,Rango,135,123,245,122,"[animation, comedy, family, western, adventure]"
172,31,17-Jul-13,Turbo,135,83,286,203,"[animation, family]"
173,32,3-Jun-16,Teenage Mutant Ninja Turtles: Out of the Shadows,135,82,245,163,"[action, adventure, comedy, family, sci-fi]"
174,33,18-Nov-11,Happy Feet Two,135,64,157,93,"[animation, comedy, family]"
175,35,2-Nov-18,The Nutcracker and the Four Realms,132,54,170,116,"[fantasy, adventure, family]"
176,36,29-Jun-05,War of the Worlds,132,234,606,372,[documentary]
177,37,26-Nov-14,Penguins of Madagascar,132,83,366,283,"[family, animation, adventure, comedy]"
178,38,22-Nov-13,The Hunger Games: Catching Fire,130,424,864,440,"[adventure, action, sci-fi]"
179,40,3-Aug-07,The Bourne Ultimatum,130,227,444,217,"[action, drama, mystery, thriller]"
180,41,6-Jul-18,Ant-Man and the Wasp,130,216,623,407,"[action, adventure, sci-fi, comedy]"
181,43,17-Jul-15,Ant-Man,130,180,518,338,"[sci-fi, action, adventure]"
182,44,27-Mar-15,Home,130,177,385,208,"[drama, mystery]"
183,44,27-Mar-15,Home,130,177,385,208,[]
184,44,27-Mar-15,Home,130,177,385,208,"[fantasy, comedy, animation, sci-fi, family]"
185,44,27-Mar-15,Home,130,177,385,208,[]
186,44,27-Mar-15,Home,130,177,385,208,"[horror, drama, family]"
187,44,27-Mar-15,Home,130,177,385,208,[drama]
188,44,27-Mar-15,Home,130,177,385,208,[sci-fi]
189,45,19-Dec-18,Mary Poppins Returns,130,171,341,170,"[fantasy, family, comedy]"
190,46,28-Oct-11,Puss in Boots,130,149,554,405,"[action, adventure, animation, family, fantasy, comedy]"
191,47,5-Nov-10,Megamind,130,148,321,173,"[animation, action, comedy, family, sci-fi]"
192,49,11-Apr-14,Rio 2,130,131,492,361,"[adventure, comedy, family, animation]"
193,50,23-Jul-10,Salt,130,118,290,172,"[action, mystery, thriller]"
194,50,23-Jul-10,Salt,130,118,290,172,"[thriller, crime]"
195,51,28-Mar-14,Noah,130,101,352,251,[drama]
196,51,28-Mar-14,Noah,130,101,352,251,"[drama, adventure]"
197,51,28-Mar-14,Noah,130,101,352,251,[documentary]
198,52,21-Dec-11,The Adventures of Tintin,130,77,373,296,"[adventure, animation, mystery]"
199,53,31-May-13,After Earth,130,60,251,191,"[sci-fi, action, adventure]"
200,55,19-Jul-13,R.I.P.D.,130,33,79,46,"[fantasy, action, comedy, crime]"
201,59,3-Mar-17,Logan,127,226,615,389,"[comedy, drama, family]"
202,59,3-Mar-17,Logan,127,226,615,389,"[action, drama, sci-fi]"
203,60,19-Dec-14,Night at the Museum: Secret of the Tomb,127,113,353,240,"[adventure, comedy, fantasy, family]"
204,62,21-Nov-14,The Hunger Games: Mockingjay - Part 1,125,337,766,429,"[sci-fi, adventure, thriller]"
205,67,29-Apr-11,Fast Five,125,210,630,420,"[action, thriller, crime]"
206,68,8-Aug-14,Teenage Mutant Ninja Turtles,125,191,485,294,"[sci-fi, action, adventure, fantasy, comedy]"
207,33,30-Mar-90,Teenage Mutant Ninja Turtles,13,135,202,67,"[sci-fi, action, adventure, fantasy, comedy]"
208,69,16-Dec-11,Sherlock Holmes: A Game of Shadows,125,186,535,349,"[adventure, action, crime, mystery]"
209,71,31-Mar-17,The Boss Baby,125,175,510,335,"[animation, comedy, family]"
210,72,1-Apr-10,Clash of the Titans,125,163,493,330,"[adventure, fantasy, action]"
211,51,12-Jun-81,Clash of the Titans,15,30,44,14,"[adventure, fantasy, action]"
212,73,4-Nov-16,Trolls,125,153,344,191,"[adventure, family, comedy, fantasy, music, animation]"
213,73,4-Nov-16,Trolls,125,153,344,191,"[adventure, family, comedy, fantasy, music, animation]"
214,75,8-Jun-12,Prometheus,125,126,402,276,"[sci-fi, adventure, mystery]"
215,76,10-Aug-12,The Bourne Legacy,125,113,280,167,"[action, thriller]"
216,78,13-Jul-18,Skyscraper,125,68,304,236,[action]
217,79,3-Aug-12,Total Recall,125,58,211,153,"[action, sci-fi, adventure, thriller]"
218,80,1-Jun-90,Total Recall,65,119,261,142,"[action, sci-fi, adventure, thriller]"
219,81,13-Jan-17,Monster Trucks,125,33,61,28,"[action, comedy, sci-fi]"
220,86,29-Jul-16,Jason Bourne,120,162,416,254,"[action, thriller]"
221,88,21-Nov-12,Life of Pi,120,124,620,496,"[adventure, drama, action]"
222,90,13-Apr-18,Rampage,120,101,428,327,"[action, adventure, sci-fi, fantasy]"
223,92,9-Aug-13,Elysium,120,93,286,193,"[sci-fi, action, drama, thriller]"
224,93,19-Apr-13,Oblivion,120,89,287,198,"[action, sci-fi, adventure, mystery]"
225,94,24-Mar-17,Power Rangers,120,85,142,57,"[action, adventure, sci-fi]"
226,96,12-Feb-14,RoboCop,120,58,242,184,"[action, sci-fi]"
227,98,7-Aug-15,Fantastic Four,120,56,167,111,"[action, adventure, sci-fi]"
228,85,8-Jul-05,Fantastic Four,87,154,333,179,"[action, adventure, sci-fi]"
229,2,23-Jun-10,Knight and Day,117,76,258,182,"[action, comedy]"
230,3,5-Oct-18,Venom,116,213,853,640,[thriller]
231,3,5-Oct-18,Venom,116,213,853,640,"[sci-fi, action]"
232,8,26-Jul-13,The Wolverine,115,132,416,284,"[action, sci-fi, adventure, fantasy]"
233,9,7-Feb-97,Dante's Peak,115,67,178,111,"[action, adventure, thriller, drama]"
234,13,25-Dec-10,Gulliver's Travels,112,42,232,190,"[comedy, adventure, family, fantasy]"
235,14,15-Dec-17,Ferdinand,111,84,289,205,"[animation, family, adventure, comedy]"
236,14,15-Dec-17,Ferdinand,111,84,289,205,"[animation, family, adventure, comedy]"
237,15,18-May-18,Deadpool 2,110,324,786,462,"[action, comedy, adventure]"
238,16,4-Oct-13,Gravity,110,274,693,419,"[sci-fi, thriller, drama]"
239,19,29-May-15,San Andreas,110,155,456,301,"[action, drama, thriller]"
240,20,29-Jul-11,The Smurfs,110,142,563,421,"[animation, family, adventure, comedy, fantasy]"
241,26,7-Mar-14,300: Rise of an Empire,110,106,330,224,"[action, war, fantasy]"
242,28,21-Dec-16,Passengers,110,100,302,202,"[drama, romance, sci-fi]"
243,28,21-Dec-16,Passengers,110,100,302,202,"[drama, romance, sci-fi]"
244,29,14-Jan-11,The Green Hornet,110,98,229,131,"[action, crime, comedy]"
245,31,7-Oct-11,Real Steel,110,85,263,178,"[action, sci-fi, drama]"
246,32,11-Jun-10,The A-Team,110,77,177,100,"[thriller, action, adventure, comedy, crime]"
247,33,31-Jul-13,The Smurfs 2,110,71,348,277,"[fantasy, family, comedy, animation]"
248,36,1-Nov-13,Ender's Game,110,61,127,66,"[sci-fi, action, adventure]"
249,40,31-Mar-17,Ghost in the Shell,110,40,167,127,"[action, sci-fi, thriller, drama]"
250,46,2-Oct-15,The Martian,108,228,655,427,"[drama, adventure, sci-fi]"
251,46,2-Oct-15,The Martian,108,228,655,427,"[drama, adventure, sci-fi]"
252,47,23-Nov-16,Allied,106,40,119,79,"[action, drama, war, romance, thriller]"
253,47,23-Nov-16,Allied,106,40,119,79,"[action, drama, war, romance, thriller]"
254,52,22-Jul-16,Ice Age: Collision Course,105,64,402,338,"[adventure, animation, family, comedy]"
255,54,22-Sep-17,Kingsman: The Golden Circle,104,100,408,308,"[action, adventure, comedy]"
256,58,9-Mar-18,A Wrinkle in Time,103,100,133,33,"[adventure, sci-fi, family, fantasy]"
257,62,21-Dec-18,Bumblebee,102,127,465,338,"[action, adventure, sci-fi]"
258,63,26-Oct-12,Cloud Atlas,102,27,130,103,"[drama, sci-fi]"
259,65,2-Jul-91,Terminator 2: Judgment Day,100,203,515,312,"[action, thriller, sci-fi]"
260,65,2-Jul-91,Terminator 2: Judgment Day,100,203,515,312,"[action, thriller, sci-fi]"
261,69,25-Dec-12,Django Unchained,100,162,449,287,"[drama, western]"
262,70,22-Dec-10,Little Fockers,100,148,310,162,"[comedy, romance]"
263,74,6-Aug-10,The Other Guys,100,119,170,51,"[action, comedy, crime]"
264,75,17-Dec-04,Lemony Snicket's A Series of Unfortunate Events,100,118,212,94,"[adventure, comedy, family]"
265,76,25-Dec-13,The Wolf of Wall Street,100,116,389,273,"[crime, drama, comedy]"
266,77,24-May-13,Epic,100,107,262,155,"[animation, adventure, family, fantasy]"
267,81,17-Aug-12,The Expendables 2,100,85,311,226,"[action, adventure, thriller]"
268,84,25-Jul-14,Hercules,100,72,243,171,"[action, adventure]"
269,8,13-Jun-97,Hercules,70,99,250,151,"[action, adventure]"
270,85,10-Dec-10,The Tourist,100,67,278,211,"[action, thriller, romance]"
271,90,24-Sep-10,Legend of the Guardians: The Owls of Ga'Hoole,100,55,139,84,"[animation, adventure, family, fantasy]"
272,96,15-Aug-14,The Expendables 3,100,39,209,170,"[action, adventure, thriller]"
273,98,12-Mar-10,Green Zone,100,35,97,62,"[war, action, adventure, drama, thriller]"
274,99,20-Oct-17,Geostorm,100,33,220,187,"[action, sci-fi, thriller]"
275,99,20-Oct-17,Geostorm,100,33,220,187,"[action, sci-fi, thriller]"
276,100,25-Dec-15,Point Break,100,28,126,98,"[action, crime, thriller]"
277,41,12-Jul-91,Point Break,24,43,83,40,"[action, crime, thriller]"
278,1,11-Dec-15,In the Heart of the Sea,100,25,89,64,"[thriller, drama, adventure, action, history]"
279,1,11-Dec-15,In the Heart of the Sea,100,25,89,64,"[thriller, drama, adventure, action, history]"
280,2,18-Apr-14,Transcendence,100,23,103,80,[]
281,2,18-Apr-14,Transcendence,100,23,103,80,"[thriller, sci-fi, drama, mystery]"
282,4,14-Dec-18,Mortal Engines,100,15,85,70,"[adventure, fantasy]"
283,7,6-Nov-15,The Peanuts Movie,99,130,250,120,"[adventure, comedy, animation, family]"
284,7,6-Nov-15,The Peanuts Movie,99,130,250,120,"[adventure, comedy, animation, family]"
285,12,19-May-17,Alien: Covenant,97,74,238,164,"[horror, sci-fi, thriller]"
286,13,13-Mar-15,Cinderella,95,201,534,333,"[comedy, romance]"
287,13,13-Mar-15,Cinderella,95,201,534,333,"[romance, fantasy, family, drama]"
288,76,15-Feb-50,Cinderella,2,85,263,178,"[comedy, romance]"
289,76,15-Feb-50,Cinderella,2,85,263,178,"[romance, fantasy, family, drama]"
290,14,13-Jul-12,Ice Age: Continental Drift,95,161,879,718,"[animation, comedy, adventure, family]"
291,16,27-May-10,Sex and the City 2,95,95,294,199,"[comedy, drama, romance]"
292,17,12-Feb-10,Percy Jackson & the Olympians: The Lightning Thief,95,88,223,135,"[adventure, fantasy, family]"
293,18,10-Aug-12,The Campaign,95,86,104,18,[comedy]
294,19,12-Nov-10,Unstoppable,95,81,165,84,"[action, thriller]"
295,19,12-Nov-10,Unstoppable,95,81,165,84,[documentary]
296,22,11-Dec-09,The Lovely Bones,95,44,94,50,"[fantasy, drama]"
297,23,19-Aug-16,Ben-Hur,95,26,91,65,"[action, adventure, drama]"
298,24,6-Feb-15,Seventh Son,95,17,108,91,"[adventure, fantasy]"
299,29,13-Feb-15,Kingsman: The Secret Service,94,128,404,276,"[crime, comedy, action, adventure]"
300,29,13-Feb-15,Kingsman: The Secret Service,94,128,404,276,"[crime, comedy, action, adventure]"
301,31,5-Aug-11,Rise of the Planet of the Apes,93,176,470,294,"[thriller, action, drama, sci-fi]"
302,34,14-Feb-13,A Good Day to Die Hard,92,67,304,237,"[action, thriller]"
303,37,25-Dec-13,The Secret Life of Walter Mitty,91,58,187,129,"[adventure, comedy, drama, fantasy]"
304,38,20-Dec-17,Jumanji: Welcome to the Jungle,90,404,964,560,"[action, adventure, comedy, fantasy]"
305,38,20-Dec-17,Jumanji: Welcome to the Jungle,90,404,964,560,"[action, adventure, comedy, fantasy]"
306,40,19-Nov-99,Toy Story 2,90,245,511,266,"[animation, comedy, family]"
307,40,19-Nov-99,Toy Story 2,90,245,511,266,"[animation, comedy, family]"
308,42,25-Dec-09,Sherlock Holmes,90,209,498,289,"[fantasy, drama, horror, action, thriller, mystery]"
309,46,15-Apr-11,Rio,90,143,487,344,"[animation, adventure, comedy, family]"
310,51,20-Dec-11,The Girl with the Dragon Tattoo,90,102,239,137,"[thriller, crime, mystery, drama]"
311,55,23-Sep-16,The Magnificent Seven,90,93,162,69,"[adventure, action, western]"
312,56,18-Dec-15,Alvin and the Chipmunks: The Road Chip,90,85,249,164,"[adventure, animation, comedy, family]"
313,59,24-Jul-15,Pixels,90,78,244,166,[sci-fi]
314,59,24-Jul-15,Pixels,90,78,244,166,"[action, comedy, sci-fi]"
315,64,7-Aug-13,Percy Jackson: Sea of Monsters,90,68,200,132,"[adventure, family, fantasy]"
316,66,10-Jun-16,Now You See Me 2,90,65,328,263,"[action, comedy, thriller]"
317,68,4-Apr-97,The Saint,90,61,169,108,"[action, adventure, crime]"
318,70,16-Mar-18,Tomb Raider,90,58,273,215,"[action, adventure, fantasy]"
319,76,19-Aug-11,Conan the Barbarian,90,21,63,42,"[adventure, fantasy, action]"
320,44,14-May-82,Conan the Barbarian,20,38,79,41,"[adventure, fantasy, action]"
321,77,21-Oct-11,The Three Musketeers,90,20,139,119,"[adventure, action, thriller]"
322,78,21-Apr-17,The Promise,90,8,10,2,[]
323,78,21-Apr-17,The Promise,90,8,10,2,"[history, romance, drama]"
324,78,21-Apr-17,The Promise,90,8,10,2,"[history, romance, drama]"
325,84,14-Sep-18,The Predator,88,51,159,108,"[sci-fi, action, thriller, adventure, horror]"
326,91,23-Jul-04,The Bourne Supremacy,85,176,311,135,"[action, drama, thriller]"
327,95,21-Mar-14,Divergent,85,150,276,126,"[action, adventure, sci-fi]"
328,96,28-Sep-12,Hotel Transylvania,85,148,378,230,"[animation, comedy, family, fantasy]"
329,99,10-Feb-12,Safe House,85,126,208,82,"[action, thriller]"
330,5,4-Nov-11,Tower Heist,85,78,150,72,"[action, comedy]"
331,7,30-Mar-12,Mirror Mirror,85,64,173,109,"[adventure, comedy, drama, family, fantasy]"
332,14,23-Nov-11,Arthur Christmas,85,46,149,103,"[drama, animation, family, comedy]"
333,15,20-Jan-17,xXx: Return of Xander Cage,85,44,345,301,"[action, adventure, crime]"
334,17,30-Jul-10,Cats & Dogs: The Revenge of Kitty Galore,85,43,113,70,"[comedy, family, action, fantasy]"
335,21,2-Mar-07,Zodiac,85,33,83,50,"[sci-fi, tv movie]"
336,24,9-May-97,Father's Day,85,28,35,7,"[action, comedy, horror]"
337,25,20-Dec-17,The Greatest Showman,84,174,386,212,[drama]
338,25,20-Dec-17,The Greatest Showman,84,174,386,212,[drama]
339,28,19-Jul-13,RED 2,84,53,141,88,"[action, comedy, crime, thriller]"
340,32,11-Jul-08,Hellboy II: The Golden Army,82,75,160,85,"[adventure, fantasy]"
341,34,13-Aug-10,The Expendables,82,103,268,165,"[thriller, adventure, action]"
342,38,23-Mar-12,The Hunger Games,80,408,677,269,"[sci-fi, adventure, fantasy]"
343,39,26-May-11,The Hangover Part II,80,254,586,332,[comedy]
344,41,10-Feb-17,The Lego Batman Movie,80,175,310,135,"[action, animation, comedy, family, fantasy]"
345,42,25-Sep-15,Hotel Transylvania 2,80,169,469,300,"[animation, comedy, family, fantasy]"
346,48,12-Jul-13,Grown Ups 2,80,133,247,114,[comedy]
347,49,16-Dec-11,Alvin and the Chipmunks: Chipwrecked,80,133,349,216,"[comedy, fantasy, family, music, animation]"
348,52,19-Feb-10,Shutter Island,80,128,299,171,"[drama, thriller, mystery]"
349,62,17-Dec-10,Yogi Bear,80,100,204,104,"[comedy, family, animation, adventure]"
350,64,15-Jan-10,The Book of Eli,80,94,158,64,"[action, thriller, sci-fi]"
351,68,17-Oct-14,Fury,80,85,210,125,"[war, drama, action]"
352,69,28-Sep-18,Smallfoot,80,83,213,130,"[animation, family, adventure, fantasy]"
353,71,8-Jul-11,Zookeeper,80,80,170,90,"[comedy, romance, family]"
354,73,8-Aug-97,Conspiracy Theory,80,76,142,66,"[action, drama, mystery, thriller]"
355,73,8-Aug-97,Conspiracy Theory,80,76,142,66,"[horror, sci-fi, thriller]"
356,89,8-Jun-01,Evolution,80,38,98,60,"[mystery, drama, horror]"
357,89,8-Jun-01,Evolution,80,38,98,60,"[mystery, drama, horror]"
358,93,20-Dec-13,Walking with Dinosaurs,80,36,123,87,"[animation, family, adventure]"
359,95,6-Dec-96,Daylight,80,32,158,126,"[thriller, horror]"
360,96,23-Oct-15,The Last Witch Hunter,80,27,130,103,"[fantasy, action, adventure, sci-fi]"
361,96,23-Oct-15,The Last Witch Hunter,80,27,130,103,"[fantasy, action, adventure, sci-fi]"
362,97,21-Feb-14,Pompeii,80,23,108,85,"[action, adventure, history, romance, drama]"
363,100,18-Dec-09,Nine,80,19,53,34,"[animation, adventure]"
364,2,22-Apr-10,Oceans,80,19,86,67,"[documentary, family]"
365,9,15-Jun-94,The Lion King,79,421,986,565,"[family, animation, drama]"
366,10,10-Feb-12,Journey 2: The Mysterious Island,79,103,318,215,"[adventure, action, sci-fi]"
367,11,11-Nov-11,Jack and Jill,79,74,150,76,[comedy]
368,13,27-Sep-13,Cloudy with a Chance of Meatballs 2,78,119,274,155,"[animation, family, comedy]"
369,19,12-Feb-16,The Little Prince,77,1,102,101,"[adventure, animation, fantasy, family]"
370,21,20-Jul-18,The Equalizer 2,77,102,190,88,"[thriller, action, crime]"
371,22,3-Jul-13,Despicable Me 2,76,368,975,607,"[animation, comedy, family]"
372,26,8-Jul-16,The Secret Life of Pets,75,368,886,518,"[adventure, comedy, animation, family]"
373,29,21-Dec-16,Sing,75,270,634,364,"[animation, comedy, drama, family]"
374,29,21-Dec-16,Sing,75,270,634,364,"[animation, comedy, drama, family]"
375,30,30-Jun-17,Despicable Me 3,75,264,1034,770,"[action, animation, comedy, family, adventure]"
376,34,25-Jun-10,Grown Ups,75,162,272,110,[comedy]
377,41,31-May-13,Now You See Me,75,117,342,225,"[thriller, crime]"
378,43,3-Aug-18,Christopher Robin,75,99,197,98,"[adventure, comedy, family, fantasy]"
379,45,11-Nov-11,Immortals,75,83,211,128,"[fantasy, action, drama]"
380,51,16-Apr-99,Life,75,64,73,9,[drama]
381,51,16-Apr-99,Life,75,64,73,9,"[horror, sci-fi, thriller]"
382,66,24-Mar-17,Life,58,30,100,70,[drama]
383,66,24-Mar-17,Life,58,30,100,70,"[horror, sci-fi, thriller]"
384,54,4-Jun-10,Killers,75,47,95,48,"[action, comedy, thriller, romance]"
385,62,25-Mar-11,Sucker Punch,75,36,89,53,"[action, fantasy, thriller]"
386,63,11-Mar-05,Hostage,75,34,77,43,"[drama, horror]"
387,64,28-Oct-16,Inferno,75,34,219,185,"[mystery, thriller, drama]"
388,64,28-Oct-16,Inferno,75,34,219,185,"[mystery, thriller, drama]"
389,73,10-Jul-15,Minions,74,336,1160,824,"[family, animation, adventure, comedy]"
390,74,6-Feb-15,The SpongeBob Movie: Sponge Out of Water,74,162,311,149,"[adventure, comedy, family, fantasy, animation]"
391,77,20-May-16,The Angry Birds Movie,73,107,352,245,"[animation, adventure, comedy]"
392,90,30-Jul-04,The Village,71,114,257,143,[drama]
393,9,22-Mar-13,Olympus Has Fallen,70,98,172,74,"[action, thriller]"
394,10,11-Mar-11,Battle: Los Angeles,70,83,213,130,"[action, sci-fi]"
395,12,25-Dec-11,War Horse,70,79,156,77,"[drama, war]"
396,14,7-Feb-14,The Monuments Men,70,78,158,80,"[war, drama, history, action]"
397,15,23-Sep-16,Storks,70,72,183,111,"[adventure, animation, comedy, family]"
398,18,17-Jun-94,Wolf,70,65,131,66,[drama]
399,18,17-Jun-94,Wolf,70,65,131,66,[horror]
400,19,20-Jan-12,Underworld: Awakening,70,62,160,98,"[fantasy, action, horror]"
401,20,22-Sep-17,The Lego Ninjago Movie,70,59,122,63,"[action, animation, adventure, family]"
402,21,10-Oct-14,Dracula Untold,70,55,220,165,"[horror, action, drama, fantasy, war]"
403,22,29-Sep-06,The Guardian,70,55,94,39,[drama]
404,22,29-Sep-06,The Guardian,70,55,94,39,"[adventure, action]"
405,25,14-Jan-11,The Dilemma,70,48,70,22,"[comedy, drama]"
406,29,15-Jun-12,Rock of Ages,70,38,61,23,"[comedy, drama, music, romance]"
407,34,7-Jun-02,Bad Company,70,30,69,39,[action]
408,36,29-Jan-16,The Finest Hours,70,27,49,22,"[action, drama, history, thriller]"
409,37,18-Oct-13,Escape Plan,70,25,103,78,"[action, thriller]"
410,38,23-Sep-11,Killer Elite,70,25,65,40,"[action, adventure, thriller]"
411,42,10-Jan-14,The Legend of Hercules,70,18,58,40,"[action, adventure]"
412,47,16-Jan-15,Blackhat,70,8,19,11,"[crime, thriller, action]"
413,50,9-Jul-10,Despicable Me,69,251,543,292,"[animation, family, comedy]"
414,51,30-Jul-10,Dinner for Schmucks,69,73,86,13,[comedy]
415,52,2-Mar-18,Red Sparrow,69,46,145,99,"[mystery, thriller]"
416,53,30-Jun-10,The Twilight Saga: Eclipse,68,300,706,406,"[adventure, fantasy, drama, romance]"
417,55,26-Jun-15,Ted 2,68,81,217,136,[comedy]
418,57,25-Feb-11,Hall Pass,68,45,87,42,"[comedy, romance]"
419,59,21-Mar-03,Dreamcatcher,68,33,75,42,[documentary]
420,59,21-Mar-03,Dreamcatcher,68,33,75,42,[drama]
421,62,22-Dec-17,Downsizing,68,24,54,30,"[comedy, drama, sci-fi]"
422,62,22-Dec-17,Downsizing,68,24,54,30,"[comedy, drama, sci-fi]"
423,65,22-Jun-12,Abraham Lincoln: Vampire Hunter,67,37,137,100,"[action, fantasy, horror]"
424,70,14-Mar-14,Need for Speed,66,43,194,151,"[action, crime, drama, thriller]"
425,72,15-Dec-00,What Women Want,65,182,374,192,"[romance, drama, comedy]"
426,73,9-Nov-12,Lincoln,65,182,273,91,"[history, drama]"
427,75,30-Jun-95,Apollo 13,65,173,335,162,"[drama, history]"
428,77,13-Jul-18,Hotel Transylvania 3: Summer Vacation,65,167,527,360,"[family, fantasy, comedy, animation]"
429,82,25-Dec-14,Unbroken,65,115,163,48,"[drama, war]"
430,84,5-Nov-10,Due Date,65,100,211,111,"[comedy, drama]"
431,89,19-Dec-14,Annie,65,85,139,54,"[comedy, drama, family]"
432,96,16-May-12,The Dictator,65,59,180,121,[comedy]
433,98,17-Feb-12,This Means War,65,54,156,102,"[action, comedy, romance]"
434,99,27-Feb-15,Focus,65,53,168,115,"[romance, comedy, crime, drama]"
435,100,8-Dec-04,Blade: Trinity,65,52,131,79,"[sci-fi, action, horror, thriller, adventure, fantasy]"
436,1,21-Nov-12,Red Dawn,65,44,48,4,"[war, action, thriller, sci-fi]"
437,3,18-Sep-15,Everest,65,43,221,178,"[adventure, drama]"
438,3,18-Sep-15,Everest,65,43,221,178,"[adventure, drama]"
439,4,14-Sep-12,Resident Evil: Retribution,65,42,240,198,"[action, horror, sci-fi]"
440,12,14-Jan-05,Elektra,65,24,56,32,[]
441,14,24-Jan-14,"I, Frankenstein",65,19,74,55,"[horror, thriller]"
442,16,22-Aug-14,Sin City: A Dame to Kill For,65,13,40,27,"[crime, thriller]"
443,17,25-Dec-16,Live by Night,65,10,21,11,"[crime, drama, thriller]"
444,17,25-Dec-16,Live by Night,65,10,21,11,"[crime, drama, thriller]"
445,27,1-Apr-11,Hop,63,108,188,80,"[animation, comedy, family]"
446,28,15-Sep-17,American Assassin,63,36,68,32,"[action, thriller]"
447,33,25-Dec-15,The Hateful Eight,62,54,147,93,"[crime, drama, mystery, western]"
448,33,25-Dec-15,The Hateful Eight,62,54,147,93,"[crime, drama, mystery, western]"
449,36,3-Oct-14,Gone Girl,61,167,368,201,"[mystery, thriller, drama]"
450,38,18-Sep-15,Maze Runner: The Scorch Trials,61,81,310,229,"[action, sci-fi, thriller]"
451,39,2-Aug-13,2 Guns,61,75,132,57,"[action, comedy, crime]"
452,40,26-Jan-18,Maze Runner: The Death Cure,61,58,265,207,"[action, sci-fi]"
453,44,7-Feb-14,The Lego Movie,60,257,457,200,"[adventure, animation, comedy, family, fantasy]"
454,50,9-Sep-16,Sully,60,125,238,113,"[drama, history]"
455,51,14-Jun-02,The Bourne Identity,60,121,214,93,"[action, drama, mystery, thriller]"
456,63,15-Oct-10,Red,60,90,196,106,[]
457,67,13-Aug-10,Eat Pray Love,60,80,206,126,[drama]
458,68,21-Dec-12,Jack Reacher,60,80,217,137,"[crime, drama, thriller, action]"
459,69,23-Apr-04,Man on Fire,60,77,130,53,[]
460,71,9-Sep-11,Contagion,60,75,137,62,"[drama, thriller, sci-fi]"
461,80,4-Mar-16,London Has Fallen,60,62,195,133,"[action, thriller]"
462,83,22-Nov-96,Jingle All the Way,60,60,129,69,[animation]
463,85,21-Oct-16,Jack Reacher: Never Go Back,60,58,159,101,"[action, thriller]"
464,85,21-Oct-16,Jack Reacher: Never Go Back,60,58,159,101,"[action, thriller]"
465,86,25-May-17,Baywatch,60,58,175,117,"[action, comedy]"
466,88,25-Dec-15,Joy,60,56,101,45,"[drama, comedy]"
467,89,17-Aug-12,ParaNorman,60,56,108,52,"[family, animation, adventure, comedy]"
468,93,19-Dec-08,The Tale of Despereaux,60,50,90,40,"[adventure, animation, family]"
469,93,19-Dec-08,The Tale of Despereaux,60,50,90,40,"[adventure, animation, family]"
470,94,26-Sep-14,The Boxtrolls,60,50,111,61,"[animation, comedy, family, fantasy]"
471,95,4-Aug-17,The Dark Tower,60,50,113,63,"[action, fantasy, sci-fi, western, horror]"
472,97,17-Jan-14,Jack Ryan: Shadow Recruit,60,50,131,81,"[action, drama, thriller]"
473,100,25-Dec-18,Vice,60,47,70,23,"[thriller, sci-fi, action, adventure]"
474,100,25-Dec-18,Vice,60,47,70,23,"[drama, history, comedy]"
475,4,11-Jan-13,Gangster Squad,60,46,104,58,"[crime, drama, action, thriller]"
476,5,7-Apr-17,Smurfs: The Lost Village,60,45,197,152,"[adventure, animation, comedy, family]"
477,6,12-Oct-18,First Man,60,44,105,61,"[history, drama]"
478,8,29-Jan-10,Edge of Darkness,60,43,82,39,"[crime, drama, mystery, thriller]"
479,8,29-Jan-10,Edge of Darkness,60,43,82,39,[documentary]
480,15,17-Apr-09,State of Play,60,37,88,51,[documentary]
481,18,21-Sep-12,Trouble with the Curve,60,35,47,12,"[drama, romance]"
482,22,15-Sep-00,Almost Famous,60,32,47,15,"[drama, music]"
483,26,21-Aug-13,The Mortal Instruments: City of Bones,60,31,75,44,"[action, adventure, drama, mystery, romance, fantasy]"
484,29,13-May-11,Priest,60,29,84,55,"[fantasy, horror]"
485,47,24-Feb-17,Rock Dog,60,9,24,15,"[adventure, animation, comedy, family, music]"
486,48,23-Jan-15,Mortdecai,60,7,30,23,"[comedy, adventure]"
487,54,23-Mar-18,Sherlock Gnomes,59,43,87,44,"[romance, animation, comedy, family, fantasy, mystery, adventure]"
488,56,12-Feb-16,Deadpool,58,363,801,438,"[action, adventure, comedy]"
489,57,25-Dec-14,American Sniper,58,350,547,197,"[war, action]"
490,57,25-Dec-14,American Sniper,58,350,547,197,"[war, action]"
491,58,16-Oct-15,Goosebumps,58,80,158,78,"[adventure, horror, comedy]"
492,58,16-Oct-15,Goosebumps,58,80,158,78,"[adventure, horror, comedy]"
493,61,20-Jan-12,Red Tails,58,49,50,1,"[drama, action, adventure, history, war]"
494,63,7-Jun-13,The Internship,58,44,93,49,[comedy]
495,70,10-Sep-10,Resident Evil: Afterlife,57,60,295,235,"[action, adventure, horror, sci-fi]"
496,71,15-Jun-12,That's My Boy,57,36,58,22,[comedy]
497,73,17-Feb-12,Ghost Rider: Spirit of Vengeance,57,51,149,98,"[action, fantasy, thriller]"
498,77,25-Dec-14,Into the Woods,56,128,213,85,"[fantasy, comedy]"
499,84,2-Nov-18,Bohemian Rhapsody,55,216,894,678,"[drama, music]"
500,91,10-Feb-17,Fifty Shades Darker,55,114,381,267,"[drama, romance]"
501,92,11-Oct-13,Captain Phillips,55,107,220,113,"[action, drama, thriller]"
502,95,10-Nov-17,Murder on the Orient Express,55,102,345,243,"[crime, drama, mystery]"
503,95,10-Nov-17,Murder on the Orient Express,55,102,345,243,"[crime, drama, mystery]"
504,96,26-Sep-14,The Equalizer,55,101,192,91,"[thriller, action, crime]"
505,97,9-Feb-18,Fifty Shades Freed,55,100,371,271,"[drama, romance]"
506,99,9-Apr-10,Date Night,55,98,152,54,[comedy]
507,5,16-Jan-15,Paddington,55,76,258,182,"[comedy, adventure, family]"
508,15,15-Mar-96,Executive Decision,55,56,122,66,"[action, adventure, drama, thriller]"
509,16,1-Nov-13,Free Birds,55,55,110,55,"[animation, comedy, family]"
510,20,21-Mar-14,Muppets Most Wanted,55,51,79,28,"[comedy, adventure, crime, family]"
511,22,19-Aug-16,Kubo and the Two Strings,55,48,77,29,"[animation, adventure, family]"
512,24,24-Nov-10,Burlesque,55,39,90,51,"[drama, romance]"
513,27,27-Jul-12,The Watch,55,34,67,33,"[action, comedy, sci-fi]"
514,28,14-Mar-03,The Hunted,55,34,47,13,[thriller]
515,32,23-Feb-18,Annihilation,55,32,43,11,[sci-fi]
516,33,16-Oct-15,Crimson Peak,55,31,74,43,"[drama, fantasy, horror, mystery, romance, thriller]"
517,33,16-Oct-15,Crimson Peak,55,31,74,43,"[drama, fantasy, horror, mystery, romance, thriller]"
518,42,1-Feb-13,Bullet to the Head,55,9,22,13,"[action, crime, thriller]"
519,59,18-Sep-15,Black Mass,53,62,98,36,"[drama, crime]"
520,59,18-Sep-15,Black Mass,53,62,98,36,[horror]
521,66,19-Dec-12,Zero Dark Thirty,52,95,134,39,"[thriller, drama, history]"
522,69,2-Jun-06,The Break-Up,52,118,205,87,"[romance, comedy]"
523,70,12-Feb-10,Valentine's Day,52,110,217,107,"[comedy, romance]"
524,72,5-Aug-11,The Change-Up,52,37,75,38,[comedy]
525,79,17-Aug-18,Alpha,51,35,99,64,[]
526,79,17-Aug-18,Alpha,51,35,99,64,"[adventure, drama]"
527,80,22-Nov-06,Deck the Halls,51,35,46,11,"[action, drama, mystery, tv movie]"
528,81,4-Mar-11,The Adjustment Bureau,50,62,126,64,"[sci-fi, thriller, romance]"
529,84,29-Jun-12,Ted,50,218,556,338,"[comedy, fantasy]"
530,85,13-Jun-14,22 Jump Street,50,191,331,140,"[crime, comedy, action]"
531,91,17-Jun-16,Central Intelligence,50,127,217,90,"[action, comedy, mystery]"
532,92,18-Dec-13,Anchorman 2: The Legend Continues,50,127,172,45,[comedy]
533,93,10-Jun-11,Super 8,50,127,257,130,"[thriller, sci-fi, mystery]"
534,96,21-Nov-18,Creed II,50,115,213,98,[drama]
535,97,9-Feb-18,Peter Rabbit,50,115,347,232,"[animation, adventure, family]"
536,100,14-Dec-18,The Mule,50,103,170,67,"[crime, comedy]"
537,100,14-Dec-18,The Mule,50,103,170,67,"[crime, drama, thriller]"
538,2,28-Feb-14,Non-Stop,50,91,222,131,"[tv movie, drama, mystery, thriller]"
539,2,28-Feb-14,Non-Stop,50,91,222,131,"[action, thriller, mystery]"
540,7,28-Jul-17,The Emoji Movie,50,86,216,130,"[animation, family, comedy]"
541,9,22-Dec-17,The Post,50,81,179,98,"[drama, history]"
542,9,22-Dec-17,The Post,50,81,179,98,"[drama, history]"
543,10,5-Feb-99,Payback,50,81,161,80,[documentary]
544,14,23-Dec-11,We Bought a Zoo,50,75,118,43,"[drama, comedy, family]"
545,15,23-Sep-11,Moneyball,50,75,111,36,[drama]
546,26,6-Apr-12,American Reunion,50,56,236,180,[comedy]
547,27,25-Jan-13,Hansel & Gretel: Witch Hunters,50,55,214,159,"[fantasy, horror, action]"
548,30,15-Jan-16,13 Hours: The Secret Soldiers of Benghazi,50,52,69,17,"[action, drama, history, thriller, war]"
549,32,29-Sep-17,American Made,50,51,135,84,"[action, crime]"
550,32,29-Sep-17,American Made,50,51,135,84,"[action, crime]"
551,35,17-Oct-14,The Book of Life,50,50,97,47,"[romance, animation, adventure, comedy, family, fantasy]"
552,40,8-Aug-14,Into the Storm,50,47,150,103,"[action, thriller]"
553,41,10-Oct-14,The Judge,50,47,76,29,[drama]
554,41,10-Oct-14,The Judge,50,47,76,29,"[documentary, documentary]"
555,45,19-Aug-16,War Dogs,50,43,86,43,"[comedy, crime, drama]"
556,56,20-May-16,The Nice Guys,50,36,59,23,"[comedy, crime, mystery]"
557,59,4-Jun-10,Marmaduke,50,33,89,56,"[family, comedy]"
558,61,15-Oct-10,Hereafter,50,32,108,76,"[drama, fantasy]"
559,63,6-Oct-95,Assassins,50,30,83,53,"[action, adventure, crime, thriller]"
560,63,6-Oct-95,Assassins,50,30,83,53,"[thriller, action, drama]"
561,64,12-Feb-16,Zoolander 2,50,28,55,27,[comedy]
562,68,29-Mar-13,The Host,50,26,64,38,"[action, adventure, romance, sci-fi, thriller]"
563,70,13-Mar-15,Run All Night,50,26,66,40,"[action, drama, thriller]"
564,74,27-Feb-04,Twisted,50,25,40,15,"[thriller, tv movie]"
565,78,8-Apr-11,Your Highness,50,21,26,5,"[fantasy, drama, action, comedy, sci-fi]"
566,78,8-Apr-11,Your Highness,50,21,26,5,"[comedy, adventure, fantasy]"
567,79,16-Sep-16,Snowden,50,21,35,14,"[drama, history, crime, thriller]"
568,80,30-Sep-11,Dream House,50,21,41,20,"[drama, thriller, mystery]"
569,81,24-Jun-16,Free State of Jones,50,20,23,3,"[action, drama, history, war]"
570,85,14-Feb-13,Beautiful Creatures,50,19,60,41,"[fantasy, drama, romance]"
571,90,3-Nov-95,Fair Game,50,11,26,15,"[drama, thriller]"
572,91,25-Feb-11,Drive Angry,50,10,41,31,"[fantasy, thriller, action, crime]"
573,98,16-Feb-18,Early Man,50,8,45,37,"[family, comedy, animation, adventure]"
574,2,17-Apr-15,Child 44,50,1,8,7,"[crime, thriller]"
575,10,2-Nov-01,The One,49,43,72,29,"[comedy, drama, romance]"
576,10,2-Nov-01,The One,49,43,72,29,"[war, drama]"
577,11,6-Mar-15,Chappie,49,31,105,74,"[crime, action, sci-fi]"
578,13,16-Nov-12,Anna Karenina,49,12,71,59,"[drama, romance]"
579,18,9-Jan-15,Taken 3,48,89,327,238,"[thriller, action]"
580,20,16-Nov-18,Instant Family,48,67,119,52,"[comedy, drama]"
581,23,22-Jan-10,Tooth Fairy,48,60,112,52,"[comedy, family, fantasy]"
582,32,13-Jul-16,The Infiltrator,47,15,20,5,"[crime, drama, thriller]"
583,34,11-Nov-16,Arrival,47,100,203,103,"[drama, sci-fi, mystery]"
584,34,11-Nov-16,Arrival,47,100,203,103,"[drama, sci-fi, mystery]"
585,40,18-Jun-10,Jonah Hex,47,10,11,1,"[action, western, drama, fantasy, thriller]"
586,42,23-Dec-16,Silence,46,7,23,16,"[drama, history]"
587,42,23-Dec-16,Silence,46,7,23,16,"[drama, history]"
588,44,20-Jun-97,My Best Friend's Wedding,46,126,298,172,"[comedy, romance]"
589,47,24-May-02,Insomnia,46,67,113,46,[]
590,48,20-Sep-13,Prisoners,46,61,113,52,"[drama, thriller, crime]"
591,54,5-Oct-12,Taken 2,45,139,377,238,"[action, crime, thriller]"
592,58,22-Dec-17,Pitch Perfect 3,45,104,185,81,"[comedy, music]"
593,58,22-Dec-17,Pitch Perfect 3,45,104,185,81,"[comedy, music]"
594,64,23-Nov-11,The Muppets,45,88,160,72,"[comedy, family, music]"
595,68,7-Oct-16,The Girl on the Train,45,75,174,99,[thriller]
596,68,7-Oct-16,The Girl on the Train,45,75,174,99,"[crime, drama, mystery, romance, thriller]"
597,68,7-Oct-16,The Girl on the Train,45,75,174,99,"[crime, drama, mystery, romance, thriller]"
598,71,21-Aug-98,Blade,45,70,131,61,"[horror, action]"
599,73,19-Mar-10,The Bounty Hunter,45,67,135,68,"[action, comedy, drama]"
600,81,9-Dec-16,Office Christmas Party,45,54,91,37,[comedy]
601,88,6-Jul-12,Savages,45,47,82,35,"[crime, drama, thriller]"
602,90,23-May-14,Blended,45,46,127,81,[comedy]
603,91,16-Jun-17,All Eyez on Me,45,44,54,10,"[drama, music]"
604,3,4-Nov-94,Frankenstein,45,22,112,90,"[horror, thriller]"
605,7,19-Jan-01,The Pledge,45,19,29,10,[drama]
606,10,1-Jul-05,Rebound,45,16,17,1,"[thriller, horror]"
607,11,19-Feb-10,The Ghost Writer,45,15,65,50,"[thriller, mystery]"
608,15,21-Sep-12,Dredd,45,13,41,28,"[action, sci-fi]"
609,16,28-Oct-11,The Rum Diary,45,13,21,8,"[drama, comedy]"
610,18,21-Dec-18,Welcome to Marwen,45,10,12,2,"[drama, comedy, fantasy]"
611,19,21-Oct-11,Johnny English Reborn,45,8,164,156,"[crime, adventure, action, comedy, thriller]"
612,27,12-Oct-12,Argo,44,136,227,91,"[drama, thriller]"
613,31,30-Jul-10,Charlie St. Cloud,44,31,48,17,"[drama, romance]"
614,33,6-Feb-14,The Interview,44,6,12,6,"[action, comedy]"
615,35,28-Jun-13,The Heat,43,159,229,70,"[action, comedy, crime]"
616,41,6-Jan-17,A Monster Calls,43,3,46,43,"[drama, fantasy]"
617,41,6-Jan-17,A Monster Calls,43,3,46,43,"[drama, fantasy]"
618,42,28-Jan-11,The Mechanic,42,29,76,47,"[action, thriller, crime]"
619,44,16-Mar-12,21 Jump Street,42,138,202,64,"[action, comedy, crime]"
620,51,12-May-17,Snatched,42,45,57,12,[comedy]
621,51,12-May-17,Snatched,42,45,57,12,"[action, comedy]"
622,52,12-Oct-12,Here Comes the Boom,42,45,73,28,"[action, comedy]"
623,55,11-Mar-11,Red Riding Hood,42,37,91,54,"[fantasy, thriller, horror]"
624,58,25-Dec-18,Holmes & Watson,42,30,41,11,"[mystery, adventure, comedy, crime]"
625,59,27-Jan-12,One for the Money,42,26,36,10,"[action, comedy, crime]"
626,63,2-Oct-92,Hero,42,19,66,47,[]
627,63,2-Oct-92,Hero,42,19,66,47,"[romance, action, drama]"
628,63,2-Oct-92,Hero,42,19,66,47,[]
629,64,27-Jan-12,Man on a Ledge,42,18,49,31,"[action, thriller, crime]"
630,65,3-Dec-10,The Warrior's Way,42,5,8,3,"[adventure, fantasy, action, western, thriller]"
631,77,11-Jun-10,The Karate Kid,40,176,351,175,"[action, adventure, drama, family]"
632,78,13-Feb-15,Fifty Shades of Grey,40,166,570,404,"[drama, romance, thriller]"
633,80,13-Dec-13,American Hustle,40,150,257,107,"[drama, crime]"
634,80,13-Dec-13,American Hustle,40,150,257,107,"[drama, crime]"
635,83,25-Jul-14,Lucy,40,126,457,331,"[action, sci-fi]"
636,84,25-Dec-13,Lone Survivor,40,125,149,24,"[action, drama, war]"
637,91,1-Oct-10,The Social Network,40,96,224,128,[drama]
638,95,15-Jan-16,Ride Along 2,40,90,124,34,"[action, comedy]"
639,97,27-Mar-15,Get Hard,40,90,106,16,[comedy]
640,100,14-Oct-16,The Accountant,40,86,152,66,"[crime, thriller, drama]"
641,100,14-Oct-16,The Accountant,40,86,152,66,"[crime, thriller, drama]"
642,1,14-Nov-14,Dumb and Dumber To,40,86,156,70,[comedy]
643,2,25-Apr-14,The Other Woman,40,83,195,112,[drama]
644,2,25-Apr-14,The Other Woman,40,83,195,112,"[comedy, romance]"
645,2,25-Apr-14,The Other Woman,40,83,195,112,"[drama, comedy, romance]"
646,6,25-Sep-15,The Intern,40,75,197,122,[comedy]
647,10,16-Oct-15,Bridge of Spies,40,72,162,90,"[thriller, drama]"
648,10,16-Oct-15,Bridge of Spies,40,72,162,90,"[thriller, drama]"
649,12,20-Mar-09,"I Love You, Man",40,72,92,20,[comedy]
650,17,4-Nov-16,Hacksaw Ridge,40,67,168,101,"[drama, history, war]"
651,17,4-Nov-16,Hacksaw Ridge,40,67,168,101,"[drama, history, war]"
652,21,18-Feb-11,Unknown,40,63,136,73,"[action, mystery, thriller]"
653,22,4-Jun-10,Get Him to the Greek,40,61,91,30,[comedy]
654,25,18-Mar-11,The Lincoln Lawyer,40,58,87,29,"[crime, drama, thriller]"
655,30,31-Jul-97,Spawn,40,54,87,33,[horror]
656,31,26-Nov-14,Horrible Bosses 2,40,54,105,51,[comedy]
657,35,9-Jul-10,Predators,40,52,127,75,"[action, sci-fi, adventure, thriller]"
658,36,15-Aug-12,The Odd Life of Timothy Green,40,51,55,4,"[fantasy, drama, comedy, family]"
659,43,20-Jun-14,Jersey Boys,40,47,65,18,"[music, drama]"
660,49,12-Aug-11,Final Destination 5,40,42,155,113,"[horror, mystery]"
661,50,16-Nov-18,Widows,40,42,73,31,"[crime, thriller]"
662,54,18-Jul-14,Sex Tape,40,38,126,88,[comedy]
663,55,15-Apr-11,Scream 4,40,38,95,57,"[horror, mystery]"
664,58,18-Mar-11,Paul,40,37,101,64,"[adventure, comedy, sci-fi]"
665,59,19-Dec-12,The Guilt Trip,40,37,41,4,[comedy]
666,60,26-Aug-11,Colombiana,40,36,72,36,"[action, thriller, crime, drama]"
667,62,12-Jan-18,The Commuter,40,36,101,65,"[action, thriller]"
668,67,8-Apr-11,Arthur,40,33,47,14,"[comedy, romance]"
669,69,21-Dec-16,Patriots Day,40,31,52,21,"[action, drama, thriller, crime, history]"
670,69,21-Dec-16,Patriots Day,40,31,52,21,"[action, drama, thriller, crime, history]"
671,73,10-Nov-10,Morning Glory,40,31,59,28,"[comedy, drama, romance]"
672,75,3-May-19,Long Shot,40,30,43,13,[documentary]
673,77,25-Dec-13,Grudge Match,40,29,69,40,[comedy]
674,81,11-Aug-17,The Nut Job 2: Nutty by Nature,40,28,57,29,"[family, animation, adventure, comedy]"
675,84,27-Jan-17,Resident Evil: The Final Chapter,40,26,314,288,"[action, horror, sci-fi]"
676,86,30-Jun-17,The House,40,25,31,6,[comedy]
677,89,7-Jan-11,Season of the Witch,40,24,91,67,"[adventure, fantasy, action]"
678,94,26-Aug-16,Mechanic: Resurrection,40,21,109,88,"[action, crime, thriller]"
679,99,3-Feb-12,Big Miracle,40,20,25,5,"[adventure, drama, romance]"
680,100,21-Dec-12,The Impossible,40,19,169,150,"[thriller, drama]"
681,1,9-Mar-12,A Thousand Words,40,18,20,2,"[drama, comedy]"
682,15,20-Mar-15,The Gunman,40,10,18,8,"[action, drama, crime]"
683,19,16-Aug-13,Paranoia,40,7,16,9,[]
684,19,16-Aug-13,Paranoia,40,7,16,9,"[drama, thriller]"
685,19,16-Aug-13,Paranoia,40,7,16,9,"[thriller, horror]"
686,19,16-Aug-13,Paranoia,40,7,16,9,[]
687,22,9-Mar-18,The Hurricane Heist,40,6,30,24,"[action, crime, thriller]"
688,24,25-Nov-15,Victor Frankenstein,40,5,31,26,"[drama, sci-fi, thriller]"
689,24,25-Nov-15,Victor Frankenstein,40,5,31,26,"[drama, sci-fi, thriller]"
690,27,27-Jun-14,Snowpiercer,40,4,88,84,"[action, sci-fi, drama]"
691,48,5-Oct-12,Frankenweenie,39,35,81,46,"[animation, comedy, family]"
692,54,22-Jun-01,The Fast and the Furious,38,144,206,62,"[action, crime, thriller]"
693,59,2-Jun-17,Captain Underpants: The First Epic Movie,38,73,126,53,"[action, animation, comedy, family]"
694,60,17-Apr-15,Paul Blart: Mall Cop 2,38,71,107,36,"[action, comedy, family]"
695,62,23-Dec-16,Why Him?,38,60,117,57,[comedy]
696,62,23-Dec-16,Why Him?,38,60,117,57,[comedy]
697,63,22-Apr-11,Water for Elephants,38,58,116,58,"[drama, romance]"
698,66,6-Sep-13,Riddick,38,42,94,52,"[sci-fi, action, thriller]"
699,68,24-May-02,Enough,38,39,50,11,"[comedy, animation]"
700,69,22-Jan-16,The 5th Wave,38,34,111,77,"[adventure, sci-fi]"
701,71,20-Sep-13,Rush,38,26,98,72,"[drama, action]"
702,75,20-Oct-17,Only the Brave,38,18,24,6,[drama]
703,77,14-Oct-11,The Thing,38,16,27,11,"[horror, sci-fi, mystery, thriller]"
704,82,21-Sep-18,The Sisters Brothers,38,3,13,10,"[comedy, drama, western]"
705,85,11-Jan-19,The Upside,37,108,119,11,"[comedy, drama]"
706,86,18-May-12,What to Expect When You're Expecting,37,41,88,47,"[romance, comedy, drama]"
707,87,14-Sep-12,The Master,37,16,50,34,[drama]
708,87,14-Sep-12,The Master,37,16,50,34,"[history, action]"
709,90,7-Aug-13,We're the Millers,37,150,267,117,"[comedy, crime]"
710,91,25-Nov-15,Creed,37,109,173,64,[drama]
711,91,25-Nov-15,Creed,37,109,173,64,[drama]
712,92,17-Sep-10,The Town,37,92,152,60,"[crime, drama, thriller]"
713,93,23-Sep-11,Dolphin Tale,37,72,96,24,"[drama, family]"
714,94,23-Feb-18,Game Night,37,69,117,48,"[mystery, comedy, crime]"
715,99,26-Feb-10,Cop Out,37,44,55,11,"[action, comedy, crime]"
716,100,28-Jan-11,The Rite,37,33,97,64,"[drama, thriller, horror]"
717,3,29-May-15,Aloha,37,21,25,4,"[drama, comedy, romance]"
718,10,26-Mar-10,Hot Tub Time Machine,36,50,65,15,"[sci-fi, comedy, adventure]"
719,12,12-Sep-14,Dolphin Tale 2,36,42,57,15,"[family, drama]"
720,13,16-Dec-16,Collateral Beauty,36,31,85,54,"[drama, romance]"
721,13,16-Dec-16,Collateral Beauty,36,31,85,54,"[drama, romance]"
722,21,6-May-11,There Be Dragons,36,1,4,3,"[drama, war]"
723,24,8-Sep-17,It,35,327,697,370,"[horror, thriller]"
724,24,8-Sep-17,It,35,327,697,370,"[horror, thriller]"
725,29,22-Dec-10,True Grit,35,171,252,81,"[drama, adventure, western]"
726,32,8-Feb-13,Identity Thief,35,134,175,41,"[comedy, crime]"
727,34,8-Jul-11,Horrible Bosses,35,117,212,95,"[comedy, crime]"
728,36,17-Jul-15,Trainwreck,35,110,141,31,"[comedy, romance]"
729,37,13-Dec-13,Saving Mr. Banks,35,83,114,31,"[comedy, drama, history]"
730,49,30-Apr-10,A Nightmare on Elm Street,35,63,117,54,"[horror, mystery, thriller]"
731,53,8-Oct-10,Secretariat,35,59,60,1,[drama]
732,55,22-Jul-11,Friends with Benefits,35,55,146,91,"[romance, comedy]"
733,56,20-May-16,Neighbors 2: Sorority Rising,35,55,108,53,[comedy]
734,59,29-Jun-18,Sicario: Day of the Soldado,35,50,75,25,"[action, crime, drama, thriller]"
735,62,22-May-15,Poltergeist,35,47,95,48,"[horror, thriller]"
736,22,4-Jun-82,Poltergeist,10,74,121,47,"[horror, thriller]"
737,63,12-Oct-18,Goosebumps 2: Haunted Halloween,35,46,93,47,"[adventure, comedy, fantasy, family, horror]"
738,64,19-Jan-18,12 Strong,35,45,71,26,"[war, drama, history, action]"
739,72,6-May-11,Something Borrowed,35,39,65,26,"[comedy, drama, romance]"
740,74,28-Oct-11,In Time,35,37,165,128,"[action, thriller, sci-fi]"
741,76,9-Nov-11,J. Edgar,35,37,84,47,"[drama, crime, history]"
742,78,17-Aug-18,Mile 22,35,36,66,30,[action]
743,79,8-May-15,Hot Pursuit,35,34,45,11,"[action, comedy, crime]"
744,80,25-Dec-15,Concussion,35,34,50,16,[drama]
745,80,25-Dec-15,Concussion,35,34,50,16,[drama]
746,81,13-Oct-17,The Foreigner,35,34,140,106,"[action, thriller, drama]"
747,81,13-Oct-17,The Foreigner,35,34,140,106,"[action, thriller, drama]"
748,89,1-Jun-18,Adrift,35,31,57,26,[documentary]
749,89,1-Jun-18,Adrift,35,31,57,26,"[thriller, romance, adventure]"
750,91,6-Jan-17,Underworld: Blood Wars,35,30,81,51,"[action, fantasy, horror, drama]"
751,93,20-Aug-10,Nanny McPhee and the Big Bang,35,29,97,68,"[comedy, fantasy, family]"
752,96,23-Sep-11,Abduction,35,28,86,58,"[thriller, action, mystery]"
753,100,19-Oct-12,Alex Cross,35,25,35,10,"[action, thriller, crime, mystery]"
754,4,9-Nov-01,Heist,35,23,28,5,"[action, crime]"
755,4,9-Nov-01,Heist,35,23,28,5,"[crime, action, thriller]"
756,6,4-Mar-16,Whiskey Tango Foxtrot,35,23,25,2,"[war, comedy]"
757,8,21-Aug-15,Hitman: Agent 47,35,22,82,60,"[action, crime, thriller]"
758,10,24-Aug-12,Premium Rush,35,20,31,11,"[crime, action, thriller]"
759,11,18-Jan-13,Broken City,35,19,34,15,"[thriller, crime, drama]"
760,14,25-Feb-05,Cursed,35,19,25,6,"[animation, comedy]"
761,17,30-Apr-10,Furry Vengeance,35,17,39,22,"[comedy, family]"
762,18,25-Jan-13,Parker,35,17,48,31,"[action, crime]"
763,24,27-May-11,The Tree of Life,35,13,61,48,"[drama, fantasy]"
764,26,11-Aug-06,Zoom,35,11,12,1,"[animation, comedy, drama]"
765,29,28-Mar-14,Sabotage,35,10,18,8,"[action, drama, thriller, crime]"
766,32,6-Mar-15,Unfinished Business,35,10,13,3,[comedy]
767,33,30-Sep-15,The Walk,35,10,61,51,"[adventure, drama, thriller]"
768,35,29-Nov-13,Mandela: Long Walk to Freedom,35,8,29,21,"[drama, history]"
769,40,20-Oct-17,The Snowman,35,6,43,37,"[drama, crime, thriller, horror]"
770,44,28-Jan-11,Biutiful,35,5,24,19,[drama]
771,47,22-Apr-16,A Hologram for the King,35,4,11,7,"[comedy, drama]"
772,58,25-Dec-11,The Darkest Hour,34,21,62,41,"[horror, action, thriller, sci-fi]"
773,59,28-Jun-17,Baby Driver,34,107,228,121,"[action, crime]"
774,60,19-Sep-14,The Maze Runner,34,102,348,246,"[action, mystery, sci-fi, thriller]"
775,61,10-Apr-15,The Longest Ride,34,37,63,26,"[drama, romance]"
776,64,3-Aug-18,The Darkest Minds,34,12,38,26,"[sci-fi, thriller]"
777,73,8-Jul-16,Mike and Dave Need Wedding Dates,33,46,75,29,[comedy]
778,74,27-Jul-12,Step Up Revolution,33,35,165,130,"[music, drama, romance]"
779,77,8-Sep-00,The Watcher,33,28,47,19,"[horror, thriller]"
780,78,27-Apr-12,Safe,33,17,41,24,"[action, crime, thriller]"
781,85,13-May-11,Bridesmaids,32,169,289,120,"[comedy, romance]"
782,87,26-Apr-13,The Big Wedding,32,21,48,27,[comedy]
783,88,24-Feb-12,Wanderlust,32,17,24,7,"[comedy, romance]"
784,95,27-Aug-10,Takers,32,57,70,13,"[action, crime, drama, thriller]"
785,96,1-Apr-11,Source Code,32,54,140,86,"[thriller, sci-fi, mystery]"
786,97,10-Sep-99,Stigmata,32,50,89,39,"[drama, fantasy]"
787,99,20-Apr-18,I Feel Pretty,32,48,91,43,[comedy]
788,1,18-Feb-11,"Big Mommas: Like Father, Like Son",32,37,82,45,"[crime, comedy, action]"
789,4,14-Dec-79,1941,32,34,94,60,[comedy]
790,7,15-Mar-13,The Incredible Burt Wonderstone,32,22,27,5,[comedy]
791,10,12-Oct-18,Bad Times at the El Royale,32,17,29,12,"[thriller, crime, mystery, drama]"
792,11,3-Sep-10,Going the Distance,32,17,43,26,"[comedy, drama, romance]"
793,13,19-Mar-10,Repo Men,32,13,18,5,"[action, sci-fi, thriller, crime]"
794,21,15-Apr-16,Criminal,31,14,38,24,"[action, crime, sci-fi, thriller, mystery, drama]"
795,22,12-Apr-13,42,31,95,97,2,[drama]
796,23,2-Nov-12,Flight,31,93,160,67,[drama]
797,27,7-Mar-14,The Grand Budapest Hotel,31,59,163,104,"[comedy, drama]"
798,28,29-Jul-15,Vacation,31,58,102,44,[drama]
799,28,29-Jul-15,Vacation,31,58,102,44,[comedy]
800,31,28-Apr-00,Frequency,31,44,68,24,"[crime, drama, sci-fi, thriller]"
801,33,22-Jan-10,Extraordinary Measures,31,12,15,3,[drama]
802,34,25-Aug-17,Birth of the Dragon,31,6,7,1,"[action, drama]"
803,37,22-Nov-95,Toy Story,30,191,364,173,"[animation, comedy, family]"
804,37,22-Nov-95,Toy Story,30,191,364,173,"[animation, comedy, family]"
805,38,15-Aug-18,Crazy Rich Asians,30,174,238,64,"[comedy, drama, romance]"
806,42,10-Feb-12,The Vow,30,125,197,72,"[drama, romance]"
807,57,18-Dec-15,Sisters,30,87,106,19,[comedy]
808,69,28-Sep-12,Looper,30,66,170,104,"[action, thriller, sci-fi]"
809,70,1-Feb-13,Warm Bodies,30,66,115,49,"[horror, comedy, romance]"
810,72,17-Jan-14,The Nut Job,30,64,122,58,"[animation, comedy, family, adventure]"
811,75,8-Aug-12,Hope Springs,30,63,133,70,"[drama, comedy, romance]"
812,83,20-May-11,Midnight in Paris,30,56,162,106,"[fantasy, comedy, romance]"
813,84,22-Nov-17,Darkest Hour,30,56,150,94,"[drama, history]"
814,84,22-Nov-17,Darkest Hour,30,56,150,94,"[drama, history]"
815,88,11-May-18,Life of the Party,30,53,65,12,[comedy]
816,89,14-May-10,Letters to Juliet,30,53,82,29,"[comedy, drama, romance]"
817,92,24-Jul-15,Southpaw,30,52,94,42,"[action, drama]"
818,94,28-Jul-17,Atomic Blonde,30,51,98,47,"[action, mystery, thriller]"
819,100,18-Sep-15,Sicario,30,46,84,38,"[action, crime, thriller]"
820,100,18-Sep-15,Sicario,30,46,84,38,"[action, crime, thriller]"
821,3,19-Jan-18,Den of Thieves,30,44,80,36,"[action, thriller, crime]"
822,4,13-Apr-12,The Three Stooges,30,44,54,10,[comedy]
823,6,24-Oct-14,John Wick,30,43,76,33,"[action, thriller]"
824,8,24-Apr-15,The Age of Adaline,30,42,68,26,"[fantasy, drama, romance]"
825,9,6-Aug-10,Step Up 3D,30,42,165,123,"[drama, romance]"
826,11,13-Apr-12,The Cabin in the Woods,30,42,70,28,"[horror, comedy, thriller]"
827,11,13-Apr-12,The Cabin in the Woods,30,42,70,28,"[horror, comedy, thriller]"
828,14,8-Apr-11,Hanna,30,40,65,25,"[action, thriller, adventure]"
829,22,13-Sep-13,The Family,30,36,51,15,"[horror, thriller]"
830,22,13-Sep-13,The Family,30,36,51,15,"[crime, comedy, action]"
831,22,13-Sep-13,The Family,30,36,51,15,[drama]
832,23,9-Feb-18,The 15:17 to Paris,30,36,56,20,"[drama, history, thriller]"
833,25,1-Jul-11,Larry Crowne,30,35,61,26,"[comedy, romance, drama]"
834,26,18-Oct-13,Carrie,30,35,82,47,"[horror, thriller]"
835,26,18-Oct-13,Carrie,30,35,82,47,"[drama, horror]"
836,28,2-Mar-18,Death Wish,30,34,48,14,"[action, crime, drama, thriller]"
837,30,3-Jun-15,Entourage,30,32,46,14,[comedy]
838,32,8-Feb-13,Side Effects,30,32,66,34,"[thriller, crime, drama]"
839,32,8-Feb-13,Side Effects,30,32,66,34,"[music, drama]"
840,34,2-Jul-14,Deliver Us from Evil,30,30,87,57,"[thriller, crime, horror]"
841,35,1-Aug-14,Get on Up,30,30,33,3,"[drama, music]"
842,37,27-Apr-12,The Five-Year Engagement,30,28,61,33,"[romance, comedy]"
843,39,15-Jul-11,Winnie the Pooh,30,26,50,24,"[animation, family]"
844,42,14-Sep-18,White Boy Rick,30,24,25,1,"[crime, drama]"
845,45,4-Feb-11,Sanctum,30,23,108,85,"[action, thriller]"
846,47,25-Aug-17,Ballerina,30,21,96,75,"[animation, adventure, comedy, family]"
847,47,25-Aug-17,Ballerina,30,21,96,75,"[animation, adventure, comedy, family]"
848,49,19-Nov-10,The Next Three Days,30,21,67,46,"[romance, drama, thriller, crime]"
849,50,12-Jan-18,Proud Mary,30,20,21,1,"[thriller, action, crime]"
850,53,4-Oct-13,Runner Runner,30,19,60,41,"[crime, thriller, drama]"
851,55,28-Apr-17,Baahubali 2: The Conclusion,30,18,263,245,"[action, drama]"
852,58,19-Aug-11,Fright Night,30,18,40,22,"[horror, comedy]"
853,59,15-Sep-17,mother!,30,17,42,25,"[drama, horror, mystery]"
854,60,9-Oct-15,Steve Jobs,30,17,35,18,"[drama, history]"
855,60,9-Oct-15,Steve Jobs,30,17,35,18,"[drama, history]"
856,74,18-Jan-13,The Last Stand,30,12,48,36,"[action, crime, thriller]"
857,78,8-Mar-13,Dead Man Down,30,10,19,9,"[thriller, action, crime, drama]"
858,82,14-Apr-17,The Lost City of Z,30,8,17,9,"[adventure, drama, history]"
859,82,14-Apr-17,The Lost City of Z,30,8,17,9,"[adventure, drama, history]"
860,84,3-Feb-17,The Space Between Us,30,7,16,9,"[romance, adventure, sci-fi, drama]"
861,86,14-Jan-11,Barney's Version,30,7,8,1,"[comedy, drama]"
862,86,14-Jan-11,Barney's Version,30,7,8,1,"[comedy, drama]"
863,88,31-Aug-18,Kin,30,5,10,5,"[sci-fi, action]"
864,90,22-Sep-17,Stronger,30,4,8,4,[drama]
865,13,24-Feb-17,Collide,29,2,5,3,"[thriller, action]"
866,14,15-May-15,Pitch Perfect 2,29,184,287,103,"[comedy, music]"
867,16,28-Sep-18,Night School,29,77,103,26,[documentary]
868,16,28-Sep-18,Night School,29,77,103,26,[comedy]
869,17,8-Apr-16,The Boss,29,63,78,15,[comedy]
870,21,18-Aug-17,Logan Lucky,29,27,44,17,"[action, comedy, crime, drama]"
871,22,12-Aug-16,Florence Foster Jenkins,29,27,56,29,"[comedy, drama]"
872,35,14-Aug-15,Straight Outta Compton,28,161,202,41,"[drama, music]"
873,35,14-Aug-15,Straight Outta Compton,28,161,202,41,"[drama, music]"
874,36,21-Jul-17,Girls Trip,28,115,140,25,[comedy]
875,40,1-Nov-17,A Bad Moms Christmas,28,72,127,55,[comedy]
876,40,1-Nov-17,A Bad Moms Christmas,28,72,127,55,[comedy]
877,41,14-Feb-13,Safe Haven,28,71,94,23,[romance]
878,42,11-Dec-15,The Big Short,28,70,133,63,"[comedy, drama]"
879,44,10-Oct-14,"Alexander and the Terrible, Horrible, No Good, Very Bad Day",28,66,101,35,"[family, comedy]"
880,46,28-Jan-13,Last Vegas,28,63,112,49,[comedy]
881,50,15-Jun-18,Tag,28,54,77,23,[drama]
882,50,15-Jun-18,Tag,28,54,77,23,"[comedy, drama]"
883,52,25-Apr-03,Identity,28,52,82,30,[drama]
884,54,16-Apr-10,Kick-Ass,28,48,97,49,"[action, crime]"
885,60,12-Aug-11,30 Minutes or Less,28,37,40,3,"[action, adventure, comedy]"
886,64,21-Feb-14,3 Days to Kill,28,30,38,8,"[action, drama, thriller, crime]"
887,65,16-Aug-13,Kick-Ass 2,28,28,63,35,"[action, adventure, crime]"
888,67,19-Sep-14,A Walk Among the Tombstones,28,26,62,36,"[crime, drama, mystery, thriller]"
889,68,15-Jan-10,The Spy Next Door,28,24,46,22,"[action, comedy, family]"
890,69,25-Apr-14,Brick Mansions,28,20,73,53,"[action, crime, drama]"
891,72,21-Aug-15,American Ultra,28,14,30,16,"[comedy, action]"
892,74,5-Feb-16,Pride and Prejudice and Zombies,28,10,16,6,"[romance, horror, comedy, thriller]"
893,86,13-Jan-12,Joyful Noise,27,30,31,1,"[comedy, music]"
894,90,28-Oct-11,Anonymous,27,4,15,11,"[drama, history, thriller]"
895,91,18-Mar-11,Limitless,27,79,155,76,"[thriller, mystery, sci-fi]"
896,98,13-May-16,Money Monster,27,41,93,52,"[thriller, drama]"
897,100,19-Aug-11,Spy Kids: All the Time in the World,27,38,80,42,"[family, comedy, action]"
898,21,6-Aug-03,Freaky Friday,26,110,160,50,"[music, family, fantasy, tv movie, comedy]"
899,30,19-Aug-05,Red Eye,26,57,96,39,[horror]
900,33,26-Apr-13,Pain & Gain,26,49,81,32,"[thriller, crime, action, comedy]"
901,37,22-Jan-10,Legion,26,40,67,27,[horror]
902,37,22-Jan-10,Legion,26,40,67,27,[horror]
903,38,29-Aug-12,Lawless,26,37,54,17,"[crime, drama]"
904,41,4-Dec-09,Brothers,26,28,45,17,[drama]
905,41,4-Dec-09,Brothers,26,28,45,17,"[crime, drama]"
906,42,17-Oct-14,The Best of Me,26,26,41,15,"[drama, romance]"
907,45,27-Apr-12,The Raven,26,16,30,14,"[horror, action, thriller, sci-fi]"
908,45,27-Apr-12,The Raven,26,16,30,14,"[crime, thriller, mystery]"
909,50,18-Oct-13,The Fifth Estate,26,3,6,3,"[drama, thriller]"
910,63,10-Aug-11,The Help,25,169,213,44,[drama]
911,64,25-Dec-16,Hidden Figures,25,169,231,62,"[drama, history]"
912,64,25-Dec-16,Hidden Figures,25,169,231,62,"[drama, history]"
913,67,17-Jan-14,Ride Along,25,134,153,19,"[action, comedy]"
914,77,5-Feb-10,Dear John,25,80,142,62,"[drama, romance, war]"
915,79,25-Dec-12,Parental Guidance,25,77,120,43,[comedy]
916,84,21-Jan-11,No Strings Attached,25,70,149,79,"[comedy, romance]"
917,85,13-Jan-12,Contraband,25,66,98,32,"[thriller, action, drama, crime]"
918,87,20-Apr-12,The Lucky One,25,60,96,36,"[drama, romance]"
919,92,22-Apr-11,Madea's Big Happy Family,25,53,54,1,"[comedy, drama]"
920,95,27-Jan-12,The Grey,25,51,81,30,"[drama, thriller, action, adventure]"
921,95,27-Jan-12,The Grey,25,51,81,30,"[drama, thriller, action, adventure]"
922,96,28-Jan-05,Hide and Seek,25,51,123,72,"[drama, fantasy, horror]"
923,96,28-Jan-05,Hide and Seek,25,51,123,72,"[romance, drama]"
924,2,15-Aug-14,The Giver,25,45,66,21,"[drama, sci-fi]"
925,6,20-Nov-15,The Night Before,25,43,52,9,[comedy]
926,6,20-Nov-15,The Night Before,25,43,52,9,[comedy]
927,15,25-Dec-13,August: Osage County,25,37,50,13,"[comedy, drama]"
928,15,25-Dec-13,August: Osage County,25,37,50,13,"[comedy, drama]"
929,17,16-May-14,Million Dollar Arm,25,36,39,3,[drama]
930,21,7-Sep-18,Peppermint,25,35,51,16,"[thriller, action, drama]"
931,25,10-Dec-14,The Gambler,25,33,38,5,"[thriller, crime, drama]"
932,29,17-Feb-17,Fist Fight,25,32,40,8,[comedy]
933,32,9-Dec-11,The Sitter,25,30,38,8,[comedy]
934,36,11-Apr-14,Draft Day,25,28,29,1,[drama]
935,38,3-Feb-17,Rings,25,27,82,55,[horror]
936,43,26-Aug-11,Don't Be Afraid of the Dark,25,24,39,15,"[fantasy, horror, thriller]"
937,44,23-Apr-10,The Losers,25,23,29,6,"[action, adventure, crime, mystery, thriller]"
938,46,24-Aug-07,War,25,22,40,18,"[action, crime, thriller]"
939,50,11-Feb-11,The Eagle,25,19,38,19,"[adventure, drama]"
940,53,24-Mar-17,CHiPS,25,18,23,5,"[action, comedy, crime]"
941,56,22-Dec-17,Father Figures,25,17,21,4,[comedy]
942,56,22-Dec-17,Father Figures,25,17,21,4,[comedy]
943,58,25-Oct-13,The Counselor,25,16,71,55,"[thriller, crime, drama]"
944,60,7-Dec-18,Mary Queen of Scots,25,16,46,30,"[drama, history]"
945,63,18-Apr-86,Legend,25,15,23,8,"[adventure, fantasy]"
946,63,18-Apr-86,Legend,25,15,23,8,"[adventure, fantasy]"
947,63,18-Apr-86,Legend,25,15,23,8,"[crime, thriller]"
948,63,18-Apr-86,Legend,25,15,23,8,"[adventure, fantasy]"
949,63,18-Apr-86,Legend,25,15,23,8,"[crime, thriller]"
950,10,20-Nov-15,Legend,25,1,42,41,"[adventure, fantasy]"
951,10,20-Nov-15,Legend,25,1,42,41,"[adventure, fantasy]"
952,10,20-Nov-15,Legend,25,1,42,41,"[crime, thriller]"
953,10,20-Nov-15,Legend,25,1,42,41,"[adventure, fantasy]"
954,10,20-Nov-15,Legend,25,1,42,41,"[crime, thriller]"
955,66,6-Nov-09,The Box,25,15,34,19,[]
956,66,6-Nov-09,The Box,25,15,34,19,"[animation, drama]"
957,66,6-Nov-09,The Box,25,15,34,19,[thriller]
958,66,6-Nov-09,The Box,25,15,34,19,[]
959,66,6-Nov-09,The Box,25,15,34,19,[music]
960,68,8-Oct-10,My Soul to Take,25,14,16,2,"[drama, horror, mystery, thriller]"
961,74,9-Sep-11,Warrior,25,13,24,11,[drama]
962,76,22-Sep-17,Battle of the Sexes,25,12,18,6,[comedy]
963,76,22-Sep-17,Battle of the Sexes,25,12,18,6,"[comedy, drama, history]"
964,76,22-Sep-17,Battle of the Sexes,25,12,18,6,"[comedy, drama, history]"
965,77,21-Dec-12,Cirque du Soleil: Worlds Away,25,12,28,16,"[fantasy, family, music, drama]"
966,78,13-Nov-15,The 33,25,12,28,16,"[drama, history]"
967,80,15-Apr-11,The Conspirator,25,11,15,4,"[crime, drama, history]"
968,88,16-Sep-11,Straw Dogs,25,10,11,1,"[drama, thriller]"
969,94,25-Nov-09,The Road,25,8,29,21,"[crime, horror, thriller]"
970,95,12-Oct-18,Beautiful Boy,25,7,13,6,[drama]
971,95,12-Oct-18,Beautiful Boy,25,7,13,6,[drama]
972,2,25-Apr-08,Deception,25,4,12,8,[]
973,7,16-Dec-11,Carnage,25,2,38,36,"[comedy, drama]"
974,8,1-Sep-17,Tulip Fever,25,2,6,4,"[drama, romance]"
975,12,29-Jan-16,Jane Got a Gun,25,1,3,2,"[action, drama, western]"
976,36,20-Jun-14,Think Like a Man Too,24,65,70,5,"[comedy, romance]"
977,37,16-Dec-16,Fences,24,57,64,7,[drama]
978,37,16-Dec-16,Fences,24,57,64,7,[drama]
979,39,14-Oct-11,Footloose,24,51,62,11,"[drama, music, romance]"
980,40,7-Apr-17,Going in Style,24,45,78,33,"[crime, comedy]"
981,52,20-Aug-10,Piranha 3D,24,25,83,58,"[comedy, horror]"
982,53,24-Nov-10,Faster,24,23,35,12,"[crime, drama, action, thriller]"
983,58,16-Sep-11,I Don't Know How She Does It,24,9,24,15,"[romance, comedy]"
984,60,20-Dec-13,Dhoom 3,24,8,11,3,"[action, thriller]"
985,71,16-Nov-18,Green Book,23,85,322,237,"[drama, comedy]"
986,72,7-Apr-95,Bad Boys,23,65,141,76,"[action, comedy, crime, thriller]"
987,72,7-Apr-95,Bad Boys,23,65,141,76,[documentary]
988,73,16-Jan-15,The Wedding Ringer,23,64,80,16,[comedy]
989,76,7-Oct-11,The Ides of March,23,40,77,37,[drama]
990,78,5-Oct-18,The Hate U Give,23,29,35,6,"[crime, drama]"
991,80,10-Jan-14,Her,23,25,48,23,"[romance, sci-fi, drama]"
992,80,10-Jan-14,Her,23,25,48,23,"[romance, sci-fi, drama]"
993,83,20-Jan-12,Haywire,23,18,36,18,"[action, thriller, mystery]"
994,86,26-Feb-16,Eddie the Eagle,23,15,45,30,"[comedy, drama, history, adventure]"
995,3,18-Nov-16,Nocturnal Animals,22,10,32,22,"[drama, thriller]"
996,3,18-Nov-16,Nocturnal Animals,22,10,32,22,"[drama, thriller]"
997,4,24-Apr-15,The Water Diviner,22,4,31,27,"[war, drama]"
998,5,13-Jul-90,Ghost,22,217,517,300,"[family, comedy]"
999,11,28-Feb-14,Son of God,22,59,70,11,[drama]
1000,13,8-Aug-14,The Hundred-Foot Journey,22,54,94,40,[drama]
1001,17,3-Aug-12,Diary of a Wimpy Kid: Dog Days,22,49,77,28,"[comedy, family]"
1002,19,11-Nov-05,Derailed,22,36,57,21,"[drama, thriller]"
1003,21,22-Nov-13,Delivery Man,22,30,70,40,[comedy]
1004,22,5-Feb-16,"Hail, Caesar!",22,30,64,34,"[comedy, drama, mystery]"
1005,27,19-May-17,Diary of a Wimpy Kid: The Long Haul,22,20,35,15,"[comedy, family]"
1006,29,27-Nov-13,Homefront,22,20,51,31,"[action, thriller]"
1007,34,4-Sep-15,The Transporter Refueled,22,16,69,53,"[thriller, action, crime, mystery]"
1008,37,22-Aug-12,Hit & Run,22,13,17,4,"[action, comedy, romance]"
1009,40,17-Nov-17,"Roman J. Israel, Esq.",22,11,12,1,[drama]
1010,40,17-Nov-17,"Roman J. Israel, Esq.",22,11,12,1,[drama]
1011,41,4-Dec-13,Out of the Furnace,22,11,15,4,"[thriller, drama, crime]"
1012,49,31-Oct-14,Before I Go to Sleep,22,3,19,16,"[mystery, thriller]"
1013,50,8-Oct-10,Stone,22,1,4,3,"[drama, thriller]"
1014,50,8-Oct-10,Stone,22,1,4,3,"[thriller, drama]"
1015,58,22-Jun-12,To Rome with Love,21,16,74,58,"[romance, comedy, drama]"
1016,59,16-Nov-12,Silver Linings Playbook,21,132,236,104,"[drama, comedy, romance]"
1017,60,6-Apr-18,Blockers,21,60,94,34,[comedy]
1018,64,16-Apr-10,Death at a Funeral,21,42,48,6,[comedy]
1019,53,17-Aug-07,Death at a Funeral,20,8,46,38,[comedy]
1020,67,5-Nov-10,For Colored Girls,21,37,38,1,[drama]
1021,69,4-Aug-17,Kidnap,21,30,34,4,"[drama, thriller]"
1022,72,9-Dec-11,Tinker Tailor Soldier Spy,21,24,81,57,"[drama, thriller, mystery]"
1023,90,16-Nov-77,Close Encounters of the Third Kind,20,169,340,171,"[sci-fi, drama]"
1024,92,9-Dec-16,La La Land,20,151,426,275,"[comedy, drama, romance]"
1025,92,9-Dec-16,La La Land,20,151,426,275,"[comedy, drama, romance]"
1026,93,19-Jul-13,The Conjuring,20,137,318,181,"[horror, thriller]"
1027,95,17-Nov-17,Wonder,20,132,304,172,"[drama, family]"
1028,95,17-Nov-17,Wonder,20,132,304,172,"[drama, family]"
1029,98,15-Oct-10,Jackass 3D,20,117,171,54,"[comedy, documentary, action]"
1030,99,29-Jul-16,Bad Moms,20,113,180,67,[comedy]
1031,3,2-Jul-14,Tammy,20,84,96,12,[comedy]
1032,5,16-Nov-11,The Descendants,20,82,175,93,"[comedy, drama]"
1033,15,31-Mar-10,The Last Song,20,62,92,30,"[drama, family, romance]"
1034,18,18-Oct-13,12 Years a Slave,20,56,181,125,"[drama, history]"
1035,20,3-Jun-16,Me Before You,20,56,208,152,"[drama, romance]"
1036,24,14-Sep-18,A Simple Favor,20,53,97,44,"[thriller, crime, mystery, comedy, drama]"
1037,25,9-Jan-15,Selma,20,52,66,14,"[history, drama]"
1038,30,16-Mar-07,Premonition,20,47,81,34,[]
1039,32,4-Feb-05,Boogeyman,20,46,67,21,[horror]
1040,34,6-Nov-15,Spotlight,20,45,92,47,"[drama, thriller, history]"
1041,34,6-Nov-15,Spotlight,20,45,92,47,"[drama, thriller, history]"
1042,34,6-Nov-15,Spotlight,20,45,92,47,[]
1043,35,30-Mar-18,Acrimony,20,43,46,3,"[drama, thriller]"
1044,36,26-Jun-15,Max,20,42,43,1,"[adventure, drama, family]"
1045,39,17-Nov-17,The Star,20,40,62,22,"[comedy, adventure, family, fantasy, animation]"
1046,43,27-Jul-16,Nerve,20,38,70,32,"[comedy, drama]"
1047,43,27-Jul-16,Nerve,20,38,70,32,"[comedy, drama]"
1048,43,27-Jul-16,Nerve,20,38,70,32,"[mystery, adventure, crime]"
1049,48,19-Feb-16,Risen,20,36,46,10,"[drama, history]"
1050,49,18-Aug-10,Vampires Suck,20,36,81,45,"[comedy, horror]"
1051,51,1-Sep-10,The American,20,35,67,32,"[crime, drama, thriller]"
1052,55,4-Jan-13,Texas Chainsaw 3D,20,34,47,13,"[horror, thriller]"
1053,62,12-Mar-10,She's Out of My League,20,32,48,16,"[comedy, romance]"
1054,63,26-Nov-08,Milk,20,31,57,26,[documentary]
1055,63,26-Nov-08,Milk,20,31,57,26,"[action, adventure, comedy]"
1056,63,26-Nov-08,Milk,20,31,57,26,[horror]
1057,65,31-Aug-11,The Debt,20,31,46,15,"[drama, thriller]"
1058,76,23-Aug-13,The World's End,20,26,47,21,"[comedy, action, sci-fi]"
1059,78,24-Sep-10,You Again,20,25,32,7,"[comedy, romance]"
1060,81,25-Dec-18,On the Basis of Sex,20,24,38,14,"[drama, history]"
1061,82,14-Feb-14,Endless Love,20,23,34,11,"[drama, romance]"
1062,83,8-Sep-06,The Covenant,20,23,38,15,[horror]
1063,84,1-Jul-11,Monte Carlo,20,23,39,16,"[adventure, comedy, romance]"
1064,87,16-Jun-17,Rough Night,20,22,46,24,"[drama, comedy]"
1065,94,20-Nov-15,Secret in Their Eyes,20,20,32,12,"[crime, drama, mystery, thriller]"
1066,94,20-Nov-15,Secret in Their Eyes,20,20,32,12,"[crime, drama, mystery, thriller]"
1067,5,26-Oct-12,Silent Hill: Revelation 3D,20,17,55,38,"[thriller, horror, mystery]"
1068,11,29-Sep-17,Flatliners,20,16,45,29,"[drama, sci-fi]"
1069,22,13-Apr-12,Lockout,20,14,33,19,"[action, thriller, sci-fi]"
1070,24,30-Sep-11,What's Your Number?,20,14,30,16,"[comedy, romance]"
1071,27,30-Oct-15,Burnt,20,13,36,23,"[drama, comedy]"
1072,27,30-Oct-15,Burnt,20,13,36,23,"[drama, comedy]"
1073,33,26-Feb-16,Triple 9,20,12,25,13,"[action, thriller, mystery]"
1074,34,2-Sep-16,The Light Between Oceans,20,12,22,10,"[drama, romance]"
1075,38,1-Oct-10,Let Me In,20,12,28,16,"[drama, horror, mystery]"
1076,38,1-Oct-10,Let Me In,20,12,28,16,[drama]
1077,51,20-Sep-13,Battle of the Year,20,8,16,8,"[music, drama]"
1078,56,12-Dec-14,Inherent Vice,20,8,14,6,"[comedy, romance, crime, drama, mystery]"
1079,56,12-Dec-14,Inherent Vice,20,8,14,6,"[comedy, romance, crime, drama, mystery]"
1080,58,11-Oct-13,Machete Kills,20,8,18,10,"[action, crime, thriller]"
1081,65,24-Apr-15,Little Boy,20,6,17,11,"[comedy, drama, war]"
1082,67,26-Oct-12,Chasing Mavericks,20,6,8,2,[drama]
1083,68,31-Dec-14,A Most Violent Year,20,5,8,3,"[crime, drama, thriller]"
1084,68,31-Dec-14,A Most Violent Year,20,5,8,3,"[crime, drama, thriller]"
1085,69,23-Nov-11,A Dangerous Method,20,5,14,9,"[drama, thriller]"
1086,74,26-Aug-16,Hands of Stone,20,4,5,1,[drama]
1087,78,7-Sep-12,The Cold Light of Day,20,3,25,22,"[action, thriller, mystery]"
1088,81,26-Oct-18,Suspiria,20,2,7,5,"[horror, fantasy]"
1089,84,19-Mar-04,Bon Voyage,20,2,8,6,[documentary]
1090,84,19-Mar-04,Bon Voyage,20,2,8,6,[drama]
1091,90,29-Apr-11,Dylan Dog: Dead of Night,20,1,6,5,"[action, comedy, horror, mystery, sci-fi, thriller]"
1092,19,1-Dec-17,The Shape of Water,19,63,195,132,"[drama, fantasy, romance]"
1093,19,1-Dec-17,The Shape of Water,19,63,195,132,"[drama, fantasy, romance]"
1094,23,29-Jul-11,The Devil's Double,19,1,5,4,"[drama, action, thriller, crime, war]"
1095,27,24-Jun-11,Bad Teacher,19,100,215,115,[comedy]
1096,28,12-Aug-16,Sausage Party,19,97,141,44,"[adventure, animation, comedy, fantasy]"
1097,36,26-Feb-10,The Crazies,19,39,56,17,"[mystery, horror, action]"
1098,39,20-Aug-10,The Switch,19,27,49,22,"[comedy, romance, drama]"
1099,40,8-Jan-10,Leap Year,19,25,32,7,"[romance, comedy]"
1100,40,8-Jan-10,Leap Year,19,25,32,7,"[drama, comedy, romance]"
1101,41,8-Nov-13,The Book Thief,19,21,76,55,[drama]
1102,48,4-Mar-11,Take Me Home Tonight,19,6,7,1,"[comedy, drama, romance]"
1103,64,9-May-14,Neighbors,18,150,270,120,[comedy]
1104,67,3-Jun-88,Big,18,114,151,37,"[fantasy, drama, comedy, romance, family]"
1105,67,3-Jun-88,Big,18,114,151,37,"[fantasy, drama, comedy, romance, family]"
1106,77,25-Mar-16,My Big Fat Greek Wedding 2,18,59,92,33,"[romance, comedy, family]"
1107,78,11-Sep-15,The Perfect Guy,18,57,60,3,"[drama, thriller]"
1108,80,25-Mar-11,Diary of a Wimpy Kid: Rodrick Rules,18,52,73,21,"[family, comedy]"
1109,83,8-Apr-11,Soul Surfer,18,43,47,4,"[family, action, drama]"
1110,85,29-Jun-18,Uncle Drew,18,42,46,4,[comedy]
1111,90,26-Jul-13,Blue Jasmine,18,33,102,69,"[comedy, drama]"
1112,92,5-Dec-03,Honey,18,30,62,32,[drama]
1113,93,14-Oct-05,The Fog,18,29,37,8,"[drama, war, sci-fi]"
1114,95,7-Aug-15,Ricki and the Flash,18,26,41,15,"[comedy, drama, music]"
1115,98,13-Nov-15,Love the Coopers,18,26,42,16,"[comedy, family, drama]"
1116,4,28-Apr-17,The Circle,18,20,40,20,"[drama, fantasy, mystery, thriller]"
1117,4,28-Apr-17,The Circle,18,20,40,20,"[drama, thriller, sci-fi]"
1118,6,5-Nov-10,127 Hours,18,18,60,42,"[adventure, drama, thriller]"
1119,9,15-Jan-16,Norm of the North,18,17,30,13,"[adventure, animation, comedy, family]"
1120,11,16-Aug-13,Jobs,18,16,43,27,"[drama, history]"
1121,14,25-Jul-14,And So It Goes,18,15,17,2,"[comedy, drama, romance]"
1122,19,31-Jan-14,Labor Day,18,13,14,1,[drama]
1123,20,30-Aug-13,Getaway,18,10,11,1,"[action, crime]"
1124,31,20-Aug-10,Mao's Last Dancer,18,4,25,21,"[drama, romance]"
1125,33,11-Apr-14,The Railway Man,18,4,23,19,"[drama, history]"
1126,35,18-Mar-16,Midnight Special,18,3,7,4,"[adventure, drama, sci-fi]"
1127,36,25-Nov-16,Miss Sloane,18,3,7,4,"[drama, thriller]"
1128,36,25-Nov-16,Miss Sloane,18,3,7,4,"[drama, thriller]"
1129,66,6-Apr-18,A Quiet Place,17,188,334,146,"[drama, horror, thriller, sci-fi]"
1130,73,15-Nov-13,The Best Man Holiday,17,70,72,2,[comedy]
1131,75,28-Sep-12,Pitch Perfect,17,65,116,51,"[comedy, music, romance]"
1132,77,5-Apr-13,Evil Dead,17,54,97,43,[horror]
1133,80,20-Feb-15,"McFarland, USA",17,44,45,1,[drama]
1134,87,4-Mar-11,Beastly,17,27,38,11,"[drama, fantasy, romance, sci-fi]"
1135,4,24-Aug-12,The Apparition,17,4,10,6,"[horror, thriller]"
1136,4,24-Aug-12,The Apparition,17,4,10,6,[drama]
1137,10,10-Jun-16,Genius,17,1,7,6,"[drama, history]"
1138,17,11-Mar-16,The Young Messiah,16,6,7,1,[drama]
1139,22,18-Aug-06,The Illusionist,16,39,83,44,"[animation, drama]"
1140,33,25-May-12,Moonrise Kingdom,16,45,68,23,"[comedy, drama, romance]"
1141,34,25-Nov-11,The Artist,16,44,128,84,"[drama, comedy, romance]"
1142,39,4-Feb-11,The Roommate,16,37,52,15,"[thriller, drama, horror]"
1143,51,12-Mar-10,Remember Me,16,19,56,37,"[drama, romance]"
1144,57,3-Oct-14,Left Behind,16,14,20,6,"[thriller, action, sci-fi]"
1145,65,18-Nov-16,Bleed for This,16,5,6,1,[drama]
1146,65,18-Nov-16,Bleed for This,16,5,6,1,[drama]
1147,70,14-Nov-14,The Homesman,16,2,8,6,"[western, drama]"
1148,71,5-Apr-13,Trance,16,2,22,20,"[thriller, crime, drama, mystery]"
1149,72,16-May-14,The Immigrant,16,2,7,5,"[drama, romance]"
1150,83,21-Dec-18,Second Act,15,39,63,24,"[romance, comedy]"
1151,93,5-Dec-84,Beverly Hills Cop,15,234,316,82,"[action, comedy, crime]"
1152,2,11-Aug-17,Annabelle: Creation,15,102,305,203,"[horror, mystery, thriller]"
1153,3,25-Oct-13,Jackass Presents: Bad Grandpa,15,102,160,58,[comedy]
1154,6,28-Nov-14,The Imitation Game,15,91,227,136,"[history, drama, thriller, war]"
1155,9,18-Jan-13,Mama,15,71,148,77,[horror]
1156,13,19-Mar-10,Diary of a Wimpy Kid,15,64,76,12,"[comedy, family]"
1157,15,31-Aug-07,Halloween,15,58,77,19,"[thriller, horror]"
1158,36,19-Oct-18,Halloween,10,159,254,95,"[thriller, horror]"
1159,18,3-Feb-12,The Woman in Black,15,54,128,74,"[drama, horror, thriller]"
1160,21,10-Aug-18,BlacKkKlansman,15,49,93,44,"[crime, drama]"
1161,26,22-Feb-13,Snitch,15,42,57,15,[]
1162,26,22-Feb-13,Snitch,15,42,57,15,"[thriller, drama]"
1163,28,4-Dec-15,Krampus,15,42,61,19,"[horror, comedy, fantasy]"
1164,29,21-Sep-12,End of Watch,15,41,57,16,"[crime, drama, thriller]"
1165,33,3-Dec-14,Wild,15,37,52,15,[drama]
1166,33,3-Dec-14,Wild,15,37,52,15,[drama]
1167,35,7-Nov-14,The Theory of Everything,15,35,123,88,"[drama, romance]"
1168,36,16-Sep-11,Drive,15,35,81,46,"[drama, action, thriller, crime]"
1169,39,23-Nov-18,The Favourite,15,34,94,60,"[drama, history, comedy]"
1170,57,8-Sep-17,Home Again,15,27,37,10,"[comedy, drama, romance]"
1171,60,23-Jul-10,Ramona and Beezus,15,26,27,1,"[comedy, family]"
1172,61,27-Aug-14,The November Man,15,25,34,9,"[crime, action, thriller]"
1173,67,29-Mar-13,The Place Beyond the Pines,15,21,47,26,"[drama, crime]"
1174,76,25-Jul-14,A Most Wanted Man,15,17,36,19,[thriller]
1175,79,2-Nov-12,The Man with the Iron Fists,15,15,22,7,[action]
1176,81,1-Feb-19,Miss Bala,15,14,15,1,"[drama, action]"
1177,82,30-Nov-12,Killing Them Softly,15,14,39,25,"[crime, thriller]"
1178,84,19-Aug-11,One Day,15,13,59,46,"[drama, romance]"
1179,90,20-Jan-17,The Founder,15,12,24,12,"[drama, history]"
1180,90,20-Jan-17,The Founder,15,12,24,12,"[drama, history]"
1181,6,23-Sep-16,Queen of Katwe,15,8,10,2,[drama]
1182,10,21-May-99,The Love Letter,15,8,9,1,[]
1183,13,4-Jan-13,Promised Land,15,7,12,5,[drama]
1184,15,8-Jun-18,Hotel Artemis,15,6,12,6,"[thriller, sci-fi, action]"
1185,25,30-Oct-15,Scouts Guide to the Zombie Apocalypse,15,3,15,12,"[comedy, horror]"
1186,27,22-Sep-10,You Will Meet a Tall Dark Stranger,15,3,34,31,"[comedy, drama, romance]"
1187,29,15-Sep-10,Never Let Me Go,15,2,11,9,"[drama, romance, sci-fi]"
1188,30,9-Sep-16,The Disappointments Room,15,2,3,1,"[drama, horror, thriller]"
1189,66,1-Jul-15,Magic Mike XXL,14,66,123,57,"[comedy, drama]"
1190,81,31-Aug-12,The Possession,14,49,82,33,"[horror, thriller]"
1191,90,13-Jan-12,The Iron Lady,14,29,115,86,"[history, drama]"
1192,95,12-Mar-10,Our Family Wedding,14,20,21,1,[comedy]
1193,8,17-Nov-06,Bobby,14,11,20,9,[documentary]
1194,10,26-Oct-12,Fun Size,14,9,11,2,[comedy]
1195,16,23-Oct-15,Suffragette,14,4,34,30,"[drama, history]"
1196,18,19-Dec-14,Mr. Turner,14,3,25,22,"[history, drama]"
1197,22,6-Aug-10,Flipped,14,1,4,3,"[romance, drama]"
1198,22,6-Aug-10,Flipped,14,1,4,3,"[drama, thriller]"
1199,36,12-Oct-12,Seven Psychopaths,13,15,33,18,"[comedy, crime]"
1200,42,4-Apr-14,Under the Skin,13,2,7,5,"[thriller, sci-fi, drama]"
1201,42,4-Apr-14,Under the Skin,13,2,7,5,"[thriller, sci-fi, drama]"
1202,44,12-Sep-14,No Good Deed,13,52,54,2,"[crime, thriller]"
1203,46,3-Dec-10,Black Swan,13,106,331,225,"[drama, thriller]"
1204,48,11-Feb-11,Justin Bieber: Never Say Never,13,73,99,26,"[documentary, music, family]"
1205,49,4-Jul-18,The First Purge,13,69,136,67,"[action, sci-fi, thriller, horror]"
1206,50,16-Mar-16,Miracles from Heaven,13,61,73,12,[drama]
1207,54,24-Jun-16,The Shallows,13,55,118,63,"[horror, drama, thriller]"
1208,58,14-Feb-14,About Last Night,13,48,50,2,"[comedy, romance]"
1209,61,10-Oct-14,St. Vincent,13,44,54,10,[comedy]
1210,62,2-Jul-14,Earth to Echo,13,38,42,4,"[family, adventure, sci-fi]"
1211,72,10-Apr-15,Ex Machina,13,25,38,13,"[drama, sci-fi]"
1212,75,11-Mar-16,Eye in the Sky,13,18,35,17,"[drama, thriller, war]"
1213,77,21-Sep-12,The Perks of Being a Wallflower,13,17,33,16,[drama]
1214,80,16-Oct-15,Room,13,14,36,22,"[drama, thriller]"
1215,80,16-Oct-15,Room,13,14,36,22,"[drama, thriller]"
1216,86,17-Jul-15,Bajrangi Bhaijaan,13,8,121,113,"[action, comedy, drama]"
1217,97,26-Mar-10,Chloe,13,3,11,8,"[drama, thriller, mystery]"
1218,99,4-Dec-15,Youth,13,2,24,22,[drama]
1219,99,4-Dec-15,Youth,13,2,24,22,"[comedy, drama]"
1220,99,4-Dec-15,Youth,13,2,24,22,"[drama, history]"
1221,3,24-Jul-15,The Vatican Tapes,13,1,14,13,"[thriller, horror]"
1222,7,29-Jul-11,Attack the Block,13,1,6,5,"[action, comedy, sci-fi]"
1223,14,15-Mar-13,The Call,12,51,69,18,"[crime, thriller]"
1224,15,5-Aug-16,Operation Chromite,12,1,49,48,"[history, drama, war, action]"
1225,15,5-Aug-16,Operation Chromite,12,1,49,48,"[history, drama, war, action]"
1226,16,12-Sep-14,The Drop,12,10,19,9,"[drama, crime]"
1227,18,3-Sep-10,Machete,12,26,46,20,"[action, comedy, thriller]"
1228,28,15-Oct-10,Conviction,12,6,11,5,[drama]
1229,36,16-Apr-10,The Perfect Game,12,1,3,2,"[drama, family]"
1230,41,20-Jun-75,Jaws,12,260,470,210,[animation]
1231,43,6-Jun-14,The Fault in Our Stars,12,124,307,183,"[romance, drama]"
1232,44,9-Jul-99,American Pie,12,101,234,133,"[comedy, romance]"
1233,45,20-Apr-12,Think Like a Man,12,91,113,22,"[comedy, romance]"
1234,46,16-Apr-14,Heaven is for Real,12,91,100,9,[drama]
1235,52,24-Feb-12,Act of Valor,12,70,82,12,"[action, thriller, war]"
1236,55,3-Feb-12,Chronicle,12,64,123,59,"[sci-fi, drama, thriller]"
1237,58,2-Mar-12,Project X,12,54,103,49,"[comedy, crime]"
1238,58,2-Mar-12,Project X,12,54,103,49,[documentary]
1239,59,10-Nov-17,"Three Billboards Outside Ebbing, Missouri",12,54,160,106,"[crime, drama]"
1240,59,10-Nov-17,"Three Billboards Outside Ebbing, Missouri",12,54,160,106,"[crime, drama]"
1241,60,25-Nov-16,Lion,12,51,149,98,[drama]
1242,60,25-Nov-16,Lion,12,51,149,98,[drama]
1243,61,4-May-18,Overboard,12,50,85,35,"[romance, comedy]"
1244,65,22-Nov-13,Philomena,12,37,98,61,[drama]
1245,67,15-Feb-02,Crossroads,12,37,57,20,[thriller]
1246,68,24-Jul-15,Paper Towns,12,32,85,53,"[drama, mystery, romance]"
1247,77,12-Aug-16,Hell or High Water,12,27,37,10,"[crime, drama, thriller, western]"
1248,79,5-Jul-12,Katy Perry: Part of Me,12,25,32,7,"[documentary, music]"
1249,80,12-Dec-14,Top Five,12,25,26,1,"[drama, comedy]"
1250,84,30-Jan-15,Project Almanac,12,22,32,10,"[sci-fi, thriller]"
1251,91,15-Nov-13,Nebraska,12,17,24,7,"[drama, adventure]"
1252,94,9-Dec-11,Young Adult,12,16,22,6,"[comedy, drama]"
1253,95,1-Nov-13,About Time,12,15,89,74,"[comedy, drama, sci-fi]"
1254,96,14-Dec-18,If Beale Street Could Talk,12,14,19,5,"[drama, romance, crime]"
1255,97,14-Jul-17,Wish Upon,12,14,23,9,"[thriller, horror, fantasy]"
1256,3,10-Feb-82,Das Boot,12,11,84,73,"[drama, history, war]"
1257,3,10-Feb-82,Das Boot,12,11,84,73,"[drama, history, war]"
1258,4,21-Apr-17,Unforgettable,12,11,16,5,"[drama, thriller]"
1259,9,14-Sep-12,Arbitrage,12,7,35,28,"[drama, thriller]"
1260,13,3-Sep-93,Fortress,12,6,46,40,"[action, war]"
1261,14,1-Jun-12,For Greater Glory: The True Story of Cristiada,12,5,10,5,"[history, drama]"
1262,29,1-Mar-13,Stoker,12,1,12,11,"[drama, horror, thriller]"
1263,60,20-Nov-15,Carol,11,12,42,30,"[romance, drama]"
1264,60,20-Nov-15,Carol,11,12,42,30,"[romance, drama]"
1265,62,22-Jan-16,Dirty Grandpa,11,35,105,70,[comedy]
1266,68,10-Dec-10,The Fighter,11,93,129,36,[drama]
1267,73,22-Aug-14,If I Stay,11,50,78,28,[drama]
1268,79,4-Nov-15,Brooklyn,11,38,62,24,"[drama, romance]"
1269,79,4-Nov-15,Brooklyn,11,38,62,24,"[drama, music]"
1270,81,1-Apr-15,Woman in Gold,11,33,58,25,[drama]
1271,83,8-Dec-17,"I, Tonya",11,30,53,23,[drama]
1272,83,8-Dec-17,"I, Tonya",11,30,53,23,[drama]
1273,90,11-Jan-13,Quartet,11,18,56,38,"[drama, comedy, romance]"
1274,94,6-Dec-13,Inside Llewyn Davis,11,13,32,19,[drama]
1275,27,2-Apr-68,2001: A Space Odyssey,10,59,71,12,"[sci-fi, mystery, adventure]"
1276,37,5-Dec-97,Good Will Hunting,10,138,225,87,[drama]
1277,42,1-Jul-16,The Purge: Election Year,10,79,118,39,"[action, horror, thriller]"
1278,43,18-May-18,Book Club,10,68,91,23,[comedy]
1279,43,18-May-18,Book Club,10,68,91,23,"[comedy, romance, drama]"
1280,45,5-Jan-18,Insidious: The Last Key,10,67,167,100,"[mystery, horror, thriller]"
1281,53,3-Nov-17,Lady Bird,10,48,78,30,"[comedy, drama]"
1282,53,3-Nov-17,Lady Bird,10,48,78,30,"[comedy, drama]"
1283,55,4-May-12,The Best Exotic Marigold Hotel,10,46,134,88,"[drama, comedy]"
1284,56,8-Jun-18,Hereditary,10,44,70,26,"[horror, mystery, thriller]"
1285,57,16-Mar-18,"Love, Simon",10,40,65,25,"[comedy, drama, romance]"
1286,61,27-Oct-17,Jigsaw,10,38,102,64,"[crime, horror, mystery, thriller]"
1287,68,22-Jan-16,The Boy,10,35,68,33,"[drama, horror, thriller]"
1288,68,22-Jan-16,The Boy,10,35,68,33,"[horror, thriller, mystery]"
1289,70,19-May-17,"Everything, Everything",10,34,61,27,"[drama, romance]"
1290,71,17-Sep-10,Devil,10,33,63,30,"[horror, mystery, thriller]"
1291,73,6-Mar-15,The Second Best Exotic Marigold Hotel,10,33,90,57,"[drama, comedy]"
1292,75,28-Apr-17,How to Be a Latin Lover,10,32,62,30,[comedy]
1293,80,10-Aug-18,Slender Man,10,30,51,21,"[mystery, thriller, horror]"
1294,85,9-Sep-16,When the Bough Breaks,10,29,30,1,"[mystery, drama, horror]"
1295,91,21-Aug-15,Sinister 2,10,27,54,27,[horror]
1296,92,8-Jan-16,The Forest,10,26,40,14,"[horror, thriller]"
1297,92,8-Jan-16,The Forest,10,26,40,14,"[horror, thriller, mystery]"
1298,92,8-Jan-16,The Forest,10,26,40,14,"[drama, horror, fantasy]"
1299,98,26-Apr-13,Mud,10,21,31,10,[drama]
1300,99,12-Nov-10,Skyline,10,21,68,47,"[sci-fi, action]"
1301,100,1-Dec-17,The Disaster Artist,10,21,28,7,"[comedy, drama]"
1302,100,1-Dec-17,The Disaster Artist,10,21,28,7,"[comedy, drama]"
1303,1,16-Sep-16,Blair Witch,10,20,38,18,"[thriller, horror]"
1304,1,16-Sep-16,Blair Witch,10,20,38,18,"[thriller, horror]"
1305,7,23-Oct-15,Paranormal Activity: The Ghost Dimension,10,18,77,59,"[horror, thriller]"
1306,14,17-Jun-05,The Perfect Man,10,16,19,3,"[drama, comedy, romance, family]"
1307,17,7-Oct-16,The Birth of a Nation,10,15,16,1,[drama]
1308,17,7-Oct-16,The Birth of a Nation,10,15,16,1,[drama]
1309,22,23-Nov-11,My Week with Marilyn,10,14,34,20,[drama]
1310,23,25-Dec-14,Big Eyes,10,14,27,13,[drama]
1311,28,19-Dec-00,The Gift,10,12,44,32,[sci-fi]
1312,28,19-Dec-00,The Gift,10,12,44,32,"[mystery, drama, fantasy]"
1313,28,19-Dec-00,The Gift,10,12,44,32,"[romance, drama]"
1314,28,19-Dec-00,The Gift,10,12,44,32,"[thriller, mystery]"
1315,28,19-Dec-00,The Gift,10,12,44,32,[drama]
1316,63,7-Aug-15,The Gift,5,43,58,15,[sci-fi]
1317,63,7-Aug-15,The Gift,5,43,58,15,"[mystery, drama, fantasy]"
1318,63,7-Aug-15,The Gift,5,43,58,15,"[romance, drama]"
1319,63,7-Aug-15,The Gift,5,43,58,15,"[thriller, mystery]"
1320,63,7-Aug-15,The Gift,5,43,58,15,[drama]
1321,39,25-Jan-13,Movie 43,10,8,31,23,[comedy]
1322,40,19-Oct-18,Can You Ever Forgive Me?,10,8,11,3,"[drama, crime]"
1323,45,27-Mar-15,While We're Young,10,7,17,10,"[comedy, drama, mystery]"
1324,45,27-Mar-15,While We're Young,10,7,17,10,"[comedy, drama, mystery]"
1325,47,24-Oct-01,Bones,10,7,8,1,[drama]
1326,48,22-Jun-12,Seeking a Friend for the End of the World,10,7,11,4,"[comedy, drama, romance, sci-fi]"
1327,50,11-Nov-16,Shut In,10,6,11,5,"[drama, thriller]"
1328,51,11-Feb-11,Cedar Rapids,10,6,7,1,[comedy]
1329,52,30-Nov-12,The Collection,10,6,8,2,"[horror, thriller]"
1330,52,30-Nov-12,The Collection,10,6,8,2,[]
1331,59,20-Mar-15,Danny Collins,10,5,8,3,"[comedy, drama, music]"
1332,64,15-Jun-18,Gotti,10,4,6,2,"[crime, drama, history, thriller]"
1333,66,30-Sep-16,Denial,10,4,9,5,"[drama, history]"
1334,66,30-Sep-16,Denial,10,4,9,5,"[drama, history]"
1335,67,29-Apr-16,The Man Who Knew Infinity,10,3,12,9,[drama]
1336,68,14-Oct-16,Max Steel,10,3,4,1,"[action, adventure, sci-fi]"
1337,68,14-Oct-16,Max Steel,10,3,4,1,"[action, adventure, sci-fi]"
1338,81,3-May-13,The Iceman,10,1,3,2,"[thriller, crime, drama]"
1339,82,5-Jun-15,Testament of Youth,10,1,6,5,"[history, drama, war]"
1340,83,21-Apr-17,Free Fire,10,1,3,2,"[action, crime, mystery]"
1341,88,16-Apr-10,The Joneses,10,1,3,2,"[comedy, drama]"
1342,88,16-Apr-10,The Joneses,10,1,3,2,[documentary]
1343,90,27-Jul-12,Killer Joe,10,1,4,3,"[crime, drama, thriller]"
1344,91,2-Jun-17,Churchill,10,1,7,6,"[drama, thriller, war]"
1345,48,22-Sep-17,Friend Request,9,3,11,8,[thriller]
1346,48,22-Sep-17,Friend Request,9,3,11,8,"[horror, thriller]"
1347,51,19-Dec-12,Amour,9,6,36,30,"[drama, romance]"
1348,56,21-Dec-16,Dangal,9,12,294,282,"[drama, action]"
1349,57,19-Mar-10,The Runaways,9,3,5,2,"[drama, music]"
1350,62,11-Nov-11,Melancholia,9,3,21,18,"[drama, sci-fi]"
1351,64,13-Nov-12,Jab Tak Hai Jaan,9,3,5,2,"[drama, romance]"
1352,66,21-May-10,Kites,9,1,17,16,"[drama, action, romance]"
1353,71,18-Jul-14,The Purge: Anarchy,9,71,111,40,"[horror, thriller]"
1354,75,21-Oct-16,Ouija: Origin of Evil,9,35,81,46,"[horror, thriller]"
1355,75,21-Oct-16,Ouija: Origin of Evil,9,35,81,46,"[horror, thriller]"
1356,86,18-Nov-16,The Edge of Seventeen,9,14,19,5,"[comedy, drama]"
1357,86,18-Nov-16,The Edge of Seventeen,9,14,19,5,"[comedy, drama]"
1358,87,2-Dec-16,Jackie,9,13,36,23,[drama]
1359,92,4-Nov-16,Loving,9,7,12,5,"[romance, drama]"
1360,92,4-Nov-16,Loving,9,7,12,5,"[romance, drama]"
1361,3,22-Mar-13,The Sapphires,9,2,20,18,"[comedy, drama]"
1362,5,25-Dec-18,Destroyer,9,1,3,2,"[thriller, crime, drama, action]"
1363,27,26-Sep-86,Crocodile Dundee,8,174,328,154,"[adventure, comedy]"
1364,30,18-Nov-16,Manchester by the Sea,8,47,77,30,[drama]
1365,30,18-Nov-16,Manchester by the Sea,8,47,77,30,[drama]
1366,33,20-Feb-15,The DUFF,8,34,43,9,"[romance, comedy]"
1367,34,31-Oct-14,Nightcrawler,8,32,50,18,"[crime, drama, thriller]"
1368,36,16-Jan-19,Dragon Ball Super: Broly,8,30,122,92,"[action, animation, fantasy, adventure, comedy, sci-fi]"
1369,38,27-Sep-13,Baggage Claim,8,21,22,1,[comedy]
1370,39,7-Oct-16,Middle School: The Worst Years of My Life,8,20,23,3,"[family, comedy]"
1371,47,13-Jun-14,The Rover,8,1,3,2,"[crime, drama]"
1372,67,17-Sep-10,Easy A,8,58,76,18,[comedy]
1373,73,30-Sep-11,50/50,8,35,41,6,"[comedy, drama]"
1374,75,2-Sep-15,A Walk in the Woods,8,29,37,8,"[adventure, comedy, drama]"
1375,78,31-Jan-14,That Awkward Moment,8,26,53,27,"[comedy, romance]"
1376,79,21-Mar-08,Shutter,8,25,47,22,"[thriller, horror, sci-fi]"
1377,88,18-Sep-13,Enough Said,8,17,25,8,"[comedy, drama, romance]"
1378,91,27-Jun-14,Begin Again,8,16,68,52,"[comedy, music, romance, drama]"
1379,100,12-Jun-15,Me and Earl and the Dying Girl,8,6,9,3,"[comedy, drama]"
1380,5,2-Sep-16,Morgan,8,3,7,4,[drama]
1381,5,2-Sep-16,Morgan,8,3,7,4,"[horror, sci-fi, thriller]"
1382,6,30-Dec-15,Anomalisa,8,3,5,2,"[animation, comedy, drama, romance]"
1383,6,30-Dec-15,Anomalisa,8,3,5,2,"[animation, comedy, drama, romance]"
1384,8,29-Dec-10,Another Year,8,3,20,17,"[comedy, drama]"
1385,8,29-Dec-10,Another Year,8,3,20,17,[drama]
1386,13,6-Apr-18,Lean on Pete,8,1,2,1,"[drama, adventure]"
1387,13,6-Apr-18,Lean on Pete,8,1,2,1,"[drama, adventure]"
1388,14,19-Nov-10,Made in Dagenham,8,1,15,14,"[comedy, drama, history]"
1389,67,21-Dec-11,Albert Nobbs,7,3,8,5,[drama]
1390,68,24-Jun-16,The Neon Demon,7,1,3,2,"[thriller, horror, mystery]"
1391,77,13-Jan-17,The Bye Bye Man,7,22,31,9,"[horror, thriller]"
1392,81,30-Apr-10,Harry Brown,7,1,12,11,"[thriller, crime, drama, action]"
1393,88,29-Jun-12,Magic Mike,7,113,170,57,"[drama, comedy]"
1394,90,16-Mar-18,I Can Only Imagine,7,83,85,2,"[drama, family, music]"
1395,93,6-May-11,Jumping the Broom,7,37,38,1,[comedy]
1396,4,7-Apr-17,Gifted,7,24,36,12,"[drama, family, comedy]"
1397,11,19-Jun-15,Dope,7,17,18,1,"[crime, drama, comedy]"
1398,14,17-Jan-14,Devil's Due,7,15,36,21,[horror]
1399,23,30-Jul-10,Get Low,7,9,10,1,"[comedy, drama, mystery]"
1400,27,18-Jun-10,Cyrus,7,7,10,3,"[comedy, drama, romance]"
1401,42,22-Dec-10,Somewhere,7,1,17,16,"[comedy, drama]"
1402,43,13-Jan-12,We Need to Talk About Kevin,7,1,10,9,"[drama, thriller]"
1403,43,13-Jan-12,We Need to Talk About Kevin,7,1,10,9,"[drama, thriller]"
1404,73,21-Sep-12,House at the End of the Street,6,31,44,13,"[horror, thriller]"
1405,76,17-Sep-10,Incendies,6,6,16,10,"[drama, war, mystery]"
1406,84,3-Oct-14,Annabelle,6,84,256,172,[horror]
1407,97,2-Dec-11,Shame,6,4,20,16,[drama]
1408,97,2-Dec-11,Shame,6,4,20,16,[drama]
1409,97,2-Dec-11,Shame,6,4,20,16,"[war, drama]"
1410,99,31-May-13,The East,6,2,3,1,"[drama, thriller]"
1411,19,11-May-18,Breaking In,6,46,51,5,[]
1412,19,11-May-18,Breaking In,6,46,51,5,"[thriller, crime, action]"
1413,37,30-Nov-18,The Possession of Hannah Grace,6,14,42,28,"[horror, drama]"
1414,46,7-Sep-12,The Words,6,11,16,5,"[drama, thriller]"
1415,47,15-Jan-16,The Lady in the Van,6,10,42,32,"[comedy, drama]"
1416,47,15-Jan-16,The Lady in the Van,6,10,42,32,"[comedy, drama]"
1417,48,27-Apr-12,Bernie,6,9,10,1,"[comedy, crime, drama]"
1418,48,27-Apr-12,Bernie,6,9,10,1,"[comedy, crime, drama]"
1419,54,29-Jul-11,The Guard,6,5,21,16,"[action, comedy, thriller, crime]"
1420,61,18-Jul-14,Wish I Was Here,6,3,6,3,"[drama, comedy]"
1421,70,15-Jul-11,Snow Flower and the Secret Fan,6,1,11,10,"[drama, history]"
1422,97,2-Aug-96,Emma,5,22,37,15,[drama]
1423,97,2-Aug-96,Emma,5,22,37,15,"[thriller, horror]"
1424,97,2-Aug-96,Emma,5,22,37,15,"[thriller, horror]"
1425,18,27-Sep-13,Don Jon,5,24,41,17,"[romance, comedy, drama]"
1426,20,28-Sep-18,Hell Fest,5,11,18,7,[horror]
1427,49,24-Feb-17,Get Out,5,176,255,79,"[comedy, animation]"
1428,49,24-Feb-17,Get Out,5,176,255,79,"[mystery, thriller, horror]"
1429,50,20-Jan-17,Split,5,138,278,140,[drama]
1430,50,20-Jan-17,Split,5,138,278,140,"[horror, thriller]"
1431,50,20-Jan-17,Split,5,138,278,140,"[fantasy, drama]"
1432,50,20-Jan-17,Split,5,138,278,140,"[comedy, romance]"
1433,51,21-Oct-11,Paranormal Activity 3,5,104,207,103,[horror]
1434,54,11-Mar-16,10 Cloverfield Lane,5,72,108,36,"[thriller, sci-fi, drama]"
1435,55,22-Jul-16,Lights Out,5,67,148,81,"[thriller, mystery, horror]"
1436,56,11-Sep-15,The Visit,5,65,98,33,"[horror, thriller, mystery]"
1437,56,11-Sep-15,The Visit,5,65,98,33,[]
1438,58,13-Oct-17,Happy Death Day,5,55,125,70,"[horror, mystery, thriller]"
1439,59,19-Oct-12,Paranormal Activity 4,5,53,142,89,[horror]
1440,60,24-Oct-14,Ouija,5,50,103,53,[horror]
1441,64,23-Jun-17,The Big Sick,5,42,53,11,"[comedy, drama, romance]"
1442,69,24-Dec-03,Monster,5,34,64,30,[]
1443,69,24-Dec-03,Monster,5,34,64,30,[horror]
1444,70,3-Jan-14,Paranormal Activity: The Marked Ones,5,32,90,58,"[horror, thriller]"
1445,72,11-Apr-14,Oculus,5,27,44,17,[horror]
1446,73,1-Nov-13,Dallas Buyers Club,5,27,60,33,"[drama, history]"
1447,73,1-Nov-13,Dallas Buyers Club,5,27,60,33,"[drama, history]"
1448,74,26-Aug-15,No Escape,5,27,42,15,"[action, thriller]"
1449,76,27-Feb-15,The Lazarus Effect,5,25,38,13,[]
1450,76,27-Feb-15,The Lazarus Effect,5,25,38,13,"[thriller, horror]"
1451,78,26-Aug-11,Our Idiot Brother,5,24,25,1,"[comedy, drama]"
1452,79,9-Mar-18,The Strangers: Prey at Night,5,24,29,5,"[horror, thriller]"
1453,83,5-Jul-13,The Way Way Back,5,21,26,5,"[comedy, drama]"
1454,84,29-Aug-14,"As Above, So Below",5,21,41,20,"[horror, thriller]"
1455,90,19-Feb-16,Race,5,19,23,4,"[action, drama]"
1456,92,16-Jan-15,Still Alice,5,18,41,23,[drama]
1457,94,2-Sep-11,Apollo 18,5,17,26,9,"[horror, thriller, sci-fi]"
1458,95,23-Mar-18,"Paul, Apostle of Christ",5,17,25,8,[history]
1459,3,15-Mar-13,Spring Breakers,5,14,31,17,"[drama, crime]"
1460,4,9-Jun-17,It Comes at Night,5,13,19,6,[horror]
1461,12,3-Mar-17,Before I Fall,5,12,18,6,"[drama, mystery, thriller, fantasy]"
1462,15,29-Jan-16,Fifty Shades of Black,5,11,22,11,"[romance, comedy]"
1463,21,17-Mar-17,The Belko Experiment,5,10,11,1,"[action, thriller]"
1464,22,11-Mar-16,The Perfect Match,5,9,10,1,"[comedy, romance]"
1465,31,28-May-10,Sea Rex 3D: Journey to a Prehistoric World,5,6,16,10,[documentary]
1466,39,2-Dec-16,Incarnate,5,4,9,5,"[horror, thriller]"
1467,45,3-Mar-17,Table 19,5,3,4,1,"[comedy, drama]"
1468,49,4-Mar-16,The Other Side of the Door,5,3,12,9,"[thriller, horror]"
1469,51,10-Oct-14,Kill the Messenger,5,2,6,4,"[thriller, crime, drama, mystery]"
1470,52,17-Dec-10,Rabbit Hole,5,2,6,4,[drama]
1471,54,28-Dec-16,Paterson,5,2,10,8,"[comedy, drama, romance]"
1472,54,28-Dec-16,Paterson,5,2,10,8,"[comedy, drama, romance]"
1473,1,23-Jan-15,Mommy,4,3,17,14,[drama]
1474,9,30-Sep-11,Take Shelter,4,1,4,3,"[thriller, drama]"
1475,32,25-Mar-16,The Lobster,4,9,18,9,"[thriller, comedy, drama, romance, sci-fi]"
1476,32,25-Mar-16,The Lobster,4,9,18,9,"[thriller, comedy, drama, romance, sci-fi]"
1477,33,4-Oct-96,Bound,4,3,7,4,"[thriller, drama]"
1478,71,13-Aug-10,Animal Kingdom,4,1,8,7,"[drama, thriller, crime, mystery]"
1479,81,23-Jan-15,The Boy Next Door,4,36,53,17,[drama]
1480,81,23-Jan-15,The Boy Next Door,4,36,53,17,[thriller]
1481,85,11-Jul-14,Boyhood,4,25,57,32,[drama]
1482,87,9-Jul-10,The Kids Are All Right,4,20,36,16,"[comedy, drama]"
1483,89,18-Apr-14,A Haunted House 2,4,17,21,4,"[comedy, horror]"
1484,90,1-Mar-13,The Last Exorcism Part II,4,15,25,10,"[horror, thriller, drama]"
1485,18,24-Aug-12,Samsara,4,2,5,3,"[drama, documentary]"
1486,91,13-Apr-18,Truth or Dare,3,41,95,54,"[horror, thriller, mystery]"
1487,91,13-Apr-18,Truth or Dare,3,41,95,54,[horror]
1488,91,13-Apr-18,Truth or Dare,3,41,95,54,[action]
1489,91,13-Apr-18,Truth or Dare,3,41,95,54,[horror]
1490,91,13-Apr-18,Truth or Dare,3,41,95,54,"[thriller, horror]"
1491,94,19-Feb-16,The Witch,3,25,40,15,"[mystery, horror]"
1492,94,19-Feb-16,The Witch,3,25,40,15,"[mystery, horror]"
1493,95,2-Feb-18,Winchester,3,25,44,19,"[fantasy, mystery, thriller, horror]"
1494,96,6-Dec-02,Empire,3,17,18,1,[]
1495,97,22-Feb-13,Dark Skies,3,17,27,10,"[sci-fi, thriller, horror]"
1496,37,21-Oct-11,Margin Call,3,5,20,15,"[thriller, drama]"
1497,43,10-Oct-14,Whiplash,3,13,38,25,"[drama, music]"
1498,43,10-Oct-14,Whiplash,3,13,38,25,"[drama, music]"
1499,54,6-Jul-18,Sorry to Bother You,3,17,18,1,"[fantasy, sci-fi, comedy]"
1500,57,3-Jun-11,Beginners,3,5,14,9,"[drama, romance, comedy]"
1501,58,22-Apr-16,The Meddler,3,4,5,1,"[comedy, drama]"
1502,65,20-Oct-10,Paranormal Activity 2,3,84,177,93,"[horror, thriller]"
1503,66,28-Aug-15,War Room,3,67,73,6,"[drama, romance]"
1504,67,7-Jun-13,The Purge,3,64,91,27,"[sci-fi, horror, thriller]"
1505,69,12-Oct-12,Sinister,3,48,87,39,"[mystery, horror]"
1506,69,12-Oct-12,Sinister,3,48,87,39,"[horror, thriller, mystery]"
1507,89,1-Jun-18,Upgrade,3,11,16,5,"[action, thriller, sci-fi]"
1508,99,24-May-13,Before Midnight,3,8,23,15,"[romance, drama]"
1509,1,31-Jul-09,The Collector,3,7,10,3,"[drama, romance]"
1510,10,24-Jun-16,Swiss Army Man,3,4,5,1,"[comedy, drama, romance, fantasy, adventure]"
1511,14,17-May-13,Frances Ha,3,4,11,7,"[comedy, drama]"
1512,14,17-May-13,Frances Ha,3,4,11,7,"[comedy, drama]"
1513,21,22-Apr-16,Compadres,3,3,7,4,"[action, comedy]"
1514,25,9-Apr-10,Letters to God,3,2,3,1,"[drama, family]"
1515,26,16-Oct-98,Happiness,3,2,5,3,[documentary]
1516,29,12-May-17,The Wall,3,1,4,3,"[sci-fi, drama]"
1517,29,12-May-17,The Wall,3,1,4,3,"[thriller, war, drama]"
1518,3,2-May-14,Ida,2,3,15,12,[drama]
1519,12,11-Jan-13,A Haunted House,2,40,59,19,"[comedy, horror]"
1520,25,24-Jun-16,Hunt for the Wilderpeople,2,5,23,18,"[adventure, comedy, drama]"
1521,26,17-Aug-12,Robot & Frank,2,3,4,1,"[sci-fi, comedy, drama, crime]"
1522,60,20-Mar-15,Do You Believe?,2,12,14,2,"[fantasy, drama]"
1523,87,30-Sep-11,Courageous,2,34,35,1,[drama]
1524,94,13-Mar-15,It Follows,2,14,23,9,"[horror, thriller]"
1525,94,13-Mar-15,It Follows,2,14,23,9,"[horror, thriller]"
1526,95,13-Jul-18,Eighth Grade,2,13,14,1,"[comedy, drama]"
1527,97,9-Mar-12,Silent House,2,12,16,4,"[horror, mystery]"
1528,100,8-Apr-16,Hardcore Henry,2,9,17,8,"[action, adventure, sci-fi]"
1529,8,11-Jun-10,Winter's Bone,2,6,16,10,[drama]
1530,11,6-Oct-17,The Florida Project,2,5,11,6,[drama]
1531,17,8-Oct-10,Inside Job,2,4,7,3,[documentary]
1532,20,28-Aug-15,We Are Your Friends,2,3,10,7,"[drama, music, romance, comedy]"
1533,35,7-Aug-15,The Diary of a Teenage Girl,2,1,2,1,"[drama, romance]"
1534,37,25-Apr-14,Locke,2,1,2,1,"[drama, thriller]"
1535,2,24-Sep-10,Buried,1,1,21,20,"[drama, thriller, mystery]"
1536,6,8-Oct-10,Nowhere Boy,1,1,7,6,[drama]
1537,15,27-Aug-10,The Last Exorcism,1,41,70,29,"[horror, drama, thriller]"
1538,18,27-Jun-12,Beasts of the Southern Wild,1,12,23,11,"[drama, fantasy, adventure]"
1539,42,28-Feb-14,The Lunchbox,1,4,12,8,"[drama, romance]"
1540,63,1-Apr-11,Insidious,1,54,99,45,"[horror, thriller]"
1541,64,21-Oct-16,Moonlight,1,27,65,38,[drama]
1542,64,21-Oct-16,Moonlight,1,27,65,38,[drama]
1543,65,12-Sep-03,Cabin Fever,1,21,30,9,[horror]
1544,70,23-Mar-18,Unsane,1,7,14,7,"[horror, thriller]"
1545,71,21-Jul-95,Kids,1,7,20,13,[documentary]
1546,71,21-Jul-95,Kids,1,7,20,13,[drama]
1547,77,26-Jul-13,The To Do List,1,3,4,1,"[comedy, romance]"
1548,82,18-Jan-85,Blood Simple,1,1,2,1,"[crime, drama, thriller]"
1549,51,17-Oct-14,Dear White People,1,4,5,1,"[comedy, drama]"
1550,57,29-Oct-04,Saw,1,55,103,48,"[horror, mystery, crime]"
1551,12,6-Jan-12,The Devil Inside,1,53,101,48,"[thriller, horror]"
1552,14,17-Apr-15,Unfriended,1,32,64,32,"[horror, thriller]"
1553,17,23-Aug-13,You're Next,1,18,26,8,"[horror, thriller, mystery]"
1554,18,25-May-12,Chernobyl Diaries,1,18,42,24,"[horror, thriller]"
1555,25,29-Dec-10,Blue Valentine,1,9,16,7,"[drama, romance]"
1556,25,29-Dec-10,Blue Valentine,1,9,16,7,"[drama, romance]"
1557,29,20-Jul-18,Unfriended: Dark Web,1,8,16,8,[horror]
1558,31,25-Sep-15,The Green Inferno,1,7,12,5,"[action, adventure, horror, thriller]"
1559,32,3-Feb-17,I Am Not Your Negro,1,7,9,2,[documentary]
1560,33,19-Oct-12,The Sessions,1,6,11,5,"[drama, romance, comedy]"
1561,42,21-Oct-11,Martha Marcy May Marlene,1,2,5,3,"[drama, thriller]"
1562,52,7-Dec-01,No Man's Land,1,1,2,1,[drama]
1563,52,7-Dec-01,No Man's Land,1,1,2,1,"[drama, crime, western, thriller]"
1564,52,7-Dec-01,No Man's Land,1,1,2,1,[documentary]
